path,lx,ty,rx,by,x,y,height,width,height_blackbuck,width_blackbuck,class,abs_x/img_width,abs_y/img_height,abs_width/img_width,abs_height/img_height
/home/dexter/Desktop/blackbuck/LEK_ANNOTATION/still_images/frame14.jpg,548,649,564,669,556.0,659.0,1080,1920,20,16,0,0.28958333333333336,0.6101851851851852,0.008333333333333333,0.018518518518518517
/home/dexter/Desktop/blackbuck/LEK_ANNOTATION/still_images/frame14.jpg,584,611,600,631,592.0,621.0,1080,1920,20,16,0,0.30833333333333335,0.575,0.008333333333333333,0.018518518518518517
/home/dexter/Desktop/blackbuck/LEK_ANNOTATION/still_images/frame14.jpg,723,568,739,593,731.0,580.5,1080,1920,25,16,0,0.3807291666666667,0.5375,0.008333333333333333,0.023148148148148147
/home/dexter/Desktop/blackbuck/LEK_ANNOTATION/still_images/frame14.jpg,717,491,737,508,727.0,499.5,1080,1920,17,20,0,0.37864583333333335,0.4625,0.010416666666666666,0.01574074074074074
/home/dexter/Desktop/blackbuck/LEK_ANNOTATION/still_images/frame14.jpg,748,462,771,481,759.5,471.5,1080,1920,19,23,0,0.39557291666666666,0.43657407407407406,0.011979166666666667,0.017592592592592594
/home/dexter/Desktop/blackbuck/LEK_ANNOTATION/still_images/frame14.jpg,783,426,795,449,789.0,437.5,1080,1920,23,12,0,0.4109375,0.4050925925925926,0.00625,0.021296296296296296
/home/dexter/Desktop/blackbuck/LEK_ANNOTATION/still_images/frame14.jpg,874,344,896,362,885.0,353.0,1080,1920,18,22,0,0.4609375,0.32685185185185184,0.011458333333333333,0.016666666666666666
/home/dexter/Desktop/blackbuck/LEK_ANNOTATION/still_images/frame14.jpg,941,274,965,289,953.0,281.5,1080,1920,15,24,0,0.49635416666666665,0.26064814814814813,0.0125,0.013888888888888888
/home/dexter/Desktop/blackbuck/LEK_ANNOTATION/still_images/frame14.jpg,609,1021,625,1042,617.0,1031.5,1080,1920,21,16,0,0.32135416666666666,0.9550925925925926,0.008333333333333333,0.019444444444444445
/home/dexter/Desktop/blackbuck/LEK_ANNOTATION/still_images/frame14.jpg,850,977,861,1000,855.5,988.5,1080,1920,23,11,0,0.44557291666666665,0.9152777777777777,0.005729166666666666,0.021296296296296296
/home/dexter/Desktop/blackbuck/LEK_ANNOTATION/still_images/frame14.jpg,892,760,912,777,902.0,768.5,1080,1920,17,20,0,0.46979166666666666,0.711574074074074,0.010416666666666666,0.01574074074074074
/home/dexter/Desktop/blackbuck/LEK_ANNOTATION/still_images/frame14.jpg,1111,1058,1128,1074,1119.5,1066.0,1080,1920,16,17,0,0.5830729166666667,0.987037037037037,0.008854166666666666,0.014814814814814815
/home/dexter/Desktop/blackbuck/LEK_ANNOTATION/still_images/frame14.jpg,1137,1029,1158,1048,1147.5,1038.5,1080,1920,19,21,0,0.59765625,0.961574074074074,0.0109375,0.017592592592592594
/home/dexter/Desktop/blackbuck/LEK_ANNOTATION/still_images/frame14.jpg,1181,980,1203,999,1192.0,989.5,1080,1920,19,22,0,0.6208333333333333,0.9162037037037037,0.011458333333333333,0.017592592592592594
/home/dexter/Desktop/blackbuck/LEK_ANNOTATION/still_images/frame14.jpg,1232,970,1254,992,1243.0,981.0,1080,1920,22,22,0,0.6473958333333333,0.9083333333333333,0.011458333333333333,0.020370370370370372
/home/dexter/Desktop/blackbuck/LEK_ANNOTATION/still_images/frame14.jpg,1226,926,1246,945,1236.0,935.5,1080,1920,19,20,0,0.64375,0.8662037037037037,0.010416666666666666,0.017592592592592594
/home/dexter/Desktop/blackbuck/LEK_ANNOTATION/still_images/frame14.jpg,1255,911,1278,928,1266.5,919.5,1080,1920,17,23,0,0.6596354166666667,0.8513888888888889,0.011979166666666667,0.01574074074074074
/home/dexter/Desktop/blackbuck/LEK_ANNOTATION/still_images/frame14.jpg,1263,887,1285,906,1274.0,896.5,1080,1920,19,22,0,0.6635416666666667,0.8300925925925926,0.011458333333333333,0.017592592592592594
/home/dexter/Desktop/blackbuck/LEK_ANNOTATION/still_images/frame14.jpg,1330,794,1351,823,1340.5,808.5,1080,1920,29,21,0,0.6981770833333333,0.7486111111111111,0.0109375,0.026851851851851852
/home/dexter/Desktop/blackbuck/LEK_ANNOTATION/still_images/frame14.jpg,1356,775,1378,791,1367.0,783.0,1080,1920,16,22,0,0.7119791666666667,0.725,0.011458333333333333,0.014814814814814815
/home/dexter/Desktop/blackbuck/LEK_ANNOTATION/still_images/frame14.jpg,1382,747,1404,770,1393.0,758.5,1080,1920,23,22,0,0.7255208333333333,0.7023148148148148,0.011458333333333333,0.021296296296296296
/home/dexter/Desktop/blackbuck/LEK_ANNOTATION/still_images/frame14.jpg,1429,702,1458,725,1443.5,713.5,1080,1920,23,29,0,0.7518229166666667,0.6606481481481481,0.015104166666666667,0.021296296296296296
/home/dexter/Desktop/blackbuck/LEK_ANNOTATION/still_images/frame14.jpg,1537,623,1558,640,1547.5,631.5,1080,1920,17,21,0,0.8059895833333334,0.5847222222222223,0.0109375,0.01574074074074074
/home/dexter/Desktop/blackbuck/LEK_ANNOTATION/still_images/frame14.jpg,1625,555,1650,570,1637.5,562.5,1080,1920,15,25,0,0.8528645833333334,0.5208333333333334,0.013020833333333334,0.013888888888888888
/home/dexter/Desktop/blackbuck/LEK_ANNOTATION/still_images/frame14.jpg,1701,508,1721,528,1711.0,518.0,1080,1920,20,20,0,0.8911458333333333,0.47962962962962963,0.010416666666666666,0.018518518518518517
/home/dexter/Desktop/blackbuck/LEK_ANNOTATION/still_images/frame14.jpg,1812,401,1837,417,1824.5,409.0,1080,1920,16,25,0,0.9502604166666667,0.3787037037037037,0.013020833333333334,0.014814814814814815
/home/dexter/Desktop/blackbuck/LEK_ANNOTATION/still_images/frame14.jpg,1775,344,1800,357,1787.5,350.5,1080,1920,13,25,0,0.9309895833333334,0.324537037037037,0.013020833333333334,0.012037037037037037
/home/dexter/Desktop/blackbuck/LEK_ANNOTATION/still_images/frame14.jpg,1824,309,1844,328,1834.0,318.5,1080,1920,19,20,0,0.9552083333333333,0.2949074074074074,0.010416666666666666,0.017592592592592594
/home/dexter/Desktop/blackbuck/LEK_ANNOTATION/still_images/frame14.jpg,1875,272,1895,298,1885.0,285.0,1080,1920,26,20,0,0.9817708333333334,0.2638888888888889,0.010416666666666666,0.024074074074074074
/home/dexter/Desktop/blackbuck/LEK_ANNOTATION/still_images/frame574.jpg,581,615,598,635,589.5,625.0,1080,1920,20,17,0,0.30703125,0.5787037037037037,0.008854166666666666,0.018518518518518517
/home/dexter/Desktop/blackbuck/LEK_ANNOTATION/still_images/frame574.jpg,621,572,636,595,628.5,583.5,1080,1920,23,15,0,0.32734375,0.5402777777777777,0.0078125,0.021296296296296296
/home/dexter/Desktop/blackbuck/LEK_ANNOTATION/still_images/frame574.jpg,667,534,689,550,678.0,542.0,1080,1920,16,22,0,0.353125,0.5018518518518519,0.011458333333333333,0.014814814814814815
/home/dexter/Desktop/blackbuck/LEK_ANNOTATION/still_images/frame574.jpg,717,534,743,553,730.0,543.5,1080,1920,19,26,0,0.3802083333333333,0.5032407407407408,0.013541666666666667,0.017592592592592594
/home/dexter/Desktop/blackbuck/LEK_ANNOTATION/still_images/frame574.jpg,827,470,849,490,838.0,480.0,1080,1920,20,22,0,0.43645833333333334,0.4444444444444444,0.011458333333333333,0.018518518518518517
/home/dexter/Desktop/blackbuck/LEK_ANNOTATION/still_images/frame574.jpg,898,392,919,410,908.5,401.0,1080,1920,18,21,0,0.47317708333333336,0.3712962962962963,0.0109375,0.016666666666666666
/home/dexter/Desktop/blackbuck/LEK_ANNOTATION/still_images/frame574.jpg,848,366,871,387,859.5,376.5,1080,1920,21,23,0,0.44765625,0.3486111111111111,0.011979166666666667,0.019444444444444445
/home/dexter/Desktop/blackbuck/LEK_ANNOTATION/still_images/frame574.jpg,902,324,928,342,915.0,333.0,1080,1920,18,26,0,0.4765625,0.30833333333333335,0.013541666666666667,0.016666666666666666
/home/dexter/Desktop/blackbuck/LEK_ANNOTATION/still_images/frame574.jpg,1015,261,1038,280,1026.5,270.5,1080,1920,19,23,0,0.5346354166666667,0.25046296296296294,0.011979166666666667,0.017592592592592594
/home/dexter/Desktop/blackbuck/LEK_ANNOTATION/still_images/frame574.jpg,1098,245,1124,258,1111.0,251.5,1080,1920,13,26,0,0.5786458333333333,0.23287037037037037,0.013541666666666667,0.012037037037037037
/home/dexter/Desktop/blackbuck/LEK_ANNOTATION/still_images/frame574.jpg,673,985,696,1001,684.5,993.0,1080,1920,16,23,0,0.35651041666666666,0.9194444444444444,0.011979166666666667,0.014814814814814815
/home/dexter/Desktop/blackbuck/LEK_ANNOTATION/still_images/frame574.jpg,1036,669,1057,694,1046.5,681.5,1080,1920,25,21,0,0.5450520833333333,0.6310185185185185,0.0109375,0.023148148148148147
/home/dexter/Desktop/blackbuck/LEK_ANNOTATION/still_images/frame574.jpg,864,964,882,989,873.0,976.5,1080,1920,25,18,0,0.4546875,0.9041666666666667,0.009375,0.023148148148148147
/home/dexter/Desktop/blackbuck/LEK_ANNOTATION/still_images/frame574.jpg,1123,1056,1140,1074,1131.5,1065.0,1080,1920,18,17,0,0.5893229166666667,0.9861111111111112,0.008854166666666666,0.016666666666666666
/home/dexter/Desktop/blackbuck/LEK_ANNOTATION/still_images/frame574.jpg,1135,1043,1160,1060,1147.5,1051.5,1080,1920,17,25,0,0.59765625,0.9736111111111111,0.013020833333333334,0.01574074074074074
/home/dexter/Desktop/blackbuck/LEK_ANNOTATION/still_images/frame574.jpg,1148,1022,1174,1046,1161.0,1034.0,1080,1920,24,26,0,0.6046875,0.9574074074074074,0.013541666666666667,0.022222222222222223
/home/dexter/Desktop/blackbuck/LEK_ANNOTATION/still_images/frame574.jpg,1179,993,1201,1017,1190.0,1005.0,1080,1920,24,22,0,0.6197916666666666,0.9305555555555556,0.011458333333333333,0.022222222222222223
/home/dexter/Desktop/blackbuck/LEK_ANNOTATION/still_images/frame574.jpg,1210,956,1228,974,1219.0,965.0,1080,1920,18,18,0,0.6348958333333333,0.8935185185185185,0.009375,0.016666666666666666
/home/dexter/Desktop/blackbuck/LEK_ANNOTATION/still_images/frame574.jpg,1242,982,1266,997,1254.0,989.5,1080,1920,15,24,0,0.653125,0.9162037037037037,0.0125,0.013888888888888888
/home/dexter/Desktop/blackbuck/LEK_ANNOTATION/still_images/frame574.jpg,1226,936,1245,951,1235.5,943.5,1080,1920,15,19,0,0.6434895833333333,0.8736111111111111,0.009895833333333333,0.013888888888888888
/home/dexter/Desktop/blackbuck/LEK_ANNOTATION/still_images/frame574.jpg,1257,900,1278,919,1267.5,909.5,1080,1920,19,21,0,0.66015625,0.8421296296296297,0.0109375,0.017592592592592594
/home/dexter/Desktop/blackbuck/LEK_ANNOTATION/still_images/frame574.jpg,1302,849,1321,877,1311.5,863.0,1080,1920,28,19,0,0.6830729166666667,0.799074074074074,0.009895833333333333,0.025925925925925925
/home/dexter/Desktop/blackbuck/LEK_ANNOTATION/still_images/frame574.jpg,1358,860,1376,881,1367.0,870.5,1080,1920,21,18,0,0.7119791666666667,0.8060185185185185,0.009375,0.019444444444444445
/home/dexter/Desktop/blackbuck/LEK_ANNOTATION/still_images/frame574.jpg,1367,817,1390,837,1378.5,827.0,1080,1920,20,23,0,0.71796875,0.7657407407407407,0.011979166666666667,0.018518518518518517
/home/dexter/Desktop/blackbuck/LEK_ANNOTATION/still_images/frame574.jpg,1323,811,1345,828,1334.0,819.5,1080,1920,17,22,0,0.6947916666666667,0.7587962962962963,0.011458333333333333,0.01574074074074074
/home/dexter/Desktop/blackbuck/LEK_ANNOTATION/still_images/frame574.jpg,1359,777,1377,803,1368.0,790.0,1080,1920,26,18,0,0.7125,0.7314814814814815,0.009375,0.024074074074074074
/home/dexter/Desktop/blackbuck/LEK_ANNOTATION/still_images/frame574.jpg,1467,686,1495,703,1481.0,694.5,1080,1920,17,28,0,0.7713541666666667,0.6430555555555556,0.014583333333333334,0.01574074074074074
/home/dexter/Desktop/blackbuck/LEK_ANNOTATION/still_images/frame574.jpg,1497,657,1513,677,1505.0,667.0,1080,1920,20,16,0,0.7838541666666666,0.6175925925925926,0.008333333333333333,0.018518518518518517
/home/dexter/Desktop/blackbuck/LEK_ANNOTATION/still_images/frame574.jpg,1510,635,1536,651,1523.0,643.0,1080,1920,16,26,0,0.7932291666666667,0.5953703703703703,0.013541666666666667,0.014814814814814815
/home/dexter/Desktop/blackbuck/LEK_ANNOTATION/still_images/frame574.jpg,1559,598,1589,616,1574.0,607.0,1080,1920,18,30,0,0.8197916666666667,0.562037037037037,0.015625,0.016666666666666666
/home/dexter/Desktop/blackbuck/LEK_ANNOTATION/still_images/frame574.jpg,1668,525,1694,541,1681.0,533.0,1080,1920,16,26,0,0.8755208333333333,0.4935185185185185,0.013541666666666667,0.014814814814814815
/home/dexter/Desktop/blackbuck/LEK_ANNOTATION/still_images/frame574.jpg,1756,488,1778,510,1767.0,499.0,1080,1920,22,22,0,0.9203125,0.462037037037037,0.011458333333333333,0.020370370370370372
/home/dexter/Desktop/blackbuck/LEK_ANNOTATION/still_images/frame574.jpg,1799,472,1831,489,1815.0,480.5,1080,1920,17,32,0,0.9453125,0.4449074074074074,0.016666666666666666,0.01574074074074074
/home/dexter/Desktop/blackbuck/LEK_ANNOTATION/still_images/frame588.jpg,676,984,695,998,685.5,991.0,1080,1920,14,19,0,0.35703125,0.9175925925925926,0.009895833333333333,0.012962962962962963
/home/dexter/Desktop/blackbuck/LEK_ANNOTATION/still_images/frame588.jpg,622,570,638,588,630.0,579.0,1080,1920,18,16,0,0.328125,0.5361111111111111,0.008333333333333333,0.016666666666666666
/home/dexter/Desktop/blackbuck/LEK_ANNOTATION/still_images/frame588.jpg,671,533,693,547,682.0,540.0,1080,1920,14,22,0,0.35520833333333335,0.5,0.011458333333333333,0.012962962962962963
/home/dexter/Desktop/blackbuck/LEK_ANNOTATION/still_images/frame588.jpg,723,537,745,552,734.0,544.5,1080,1920,15,22,0,0.38229166666666664,0.5041666666666667,0.011458333333333333,0.013888888888888888
/home/dexter/Desktop/blackbuck/LEK_ANNOTATION/still_images/frame588.jpg,865,966,880,990,872.5,978.0,1080,1920,24,15,0,0.4544270833333333,0.9055555555555556,0.0078125,0.022222222222222223
/home/dexter/Desktop/blackbuck/LEK_ANNOTATION/still_images/frame588.jpg,833,469,852,488,842.5,478.5,1080,1920,19,19,0,0.4388020833333333,0.44305555555555554,0.009895833333333333,0.017592592592592594
/home/dexter/Desktop/blackbuck/LEK_ANNOTATION/still_images/frame588.jpg,1036,668,1059,686,1047.5,677.0,1080,1920,18,23,0,0.5455729166666666,0.6268518518518519,0.011979166666666667,0.016666666666666666
/home/dexter/Desktop/blackbuck/LEK_ANNOTATION/still_images/frame588.jpg,852,364,874,380,863.0,372.0,1080,1920,16,22,0,0.44947916666666665,0.34444444444444444,0.011458333333333333,0.014814814814814815
/home/dexter/Desktop/blackbuck/LEK_ANNOTATION/still_images/frame588.jpg,895,391,920,408,907.5,399.5,1080,1920,17,25,0,0.47265625,0.3699074074074074,0.013020833333333334,0.01574074074074074
/home/dexter/Desktop/blackbuck/LEK_ANNOTATION/still_images/frame588.jpg,910,322,930,338,920.0,330.0,1080,1920,16,20,0,0.4791666666666667,0.3055555555555556,0.010416666666666666,0.014814814814814815
/home/dexter/Desktop/blackbuck/LEK_ANNOTATION/still_images/frame588.jpg,1019,259,1039,274,1029.0,266.5,1080,1920,15,20,0,0.5359375,0.24675925925925926,0.010416666666666666,0.013888888888888888
/home/dexter/Desktop/blackbuck/LEK_ANNOTATION/still_images/frame588.jpg,1101,240,1129,257,1115.0,248.5,1080,1920,17,28,0,0.5807291666666666,0.2300925925925926,0.014583333333333334,0.01574074074074074
/home/dexter/Desktop/blackbuck/LEK_ANNOTATION/still_images/frame588.jpg,1125,1052,1143,1068,1134.0,1060.0,1080,1920,16,18,0,0.590625,0.9814814814814815,0.009375,0.014814814814814815
/home/dexter/Desktop/blackbuck/LEK_ANNOTATION/still_images/frame588.jpg,1141,1035,1158,1054,1149.5,1044.5,1080,1920,19,17,0,0.5986979166666667,0.9671296296296297,0.008854166666666666,0.017592592592592594
/home/dexter/Desktop/blackbuck/LEK_ANNOTATION/still_images/frame588.jpg,1155,1014,1176,1040,1165.5,1027.0,1080,1920,26,21,0,0.60703125,0.950925925925926,0.0109375,0.024074074074074074
/home/dexter/Desktop/blackbuck/LEK_ANNOTATION/still_images/frame588.jpg,1180,987,1202,1008,1191.0,997.5,1080,1920,21,22,0,0.6203125,0.9236111111111112,0.011458333333333333,0.019444444444444445
/home/dexter/Desktop/blackbuck/LEK_ANNOTATION/still_images/frame588.jpg,1209,949,1230,972,1219.5,960.5,1080,1920,23,21,0,0.63515625,0.8893518518518518,0.0109375,0.021296296296296296
/home/dexter/Desktop/blackbuck/LEK_ANNOTATION/still_images/frame588.jpg,1243,979,1265,996,1254.0,987.5,1080,1920,17,22,0,0.653125,0.9143518518518519,0.011458333333333333,0.01574074074074074
/home/dexter/Desktop/blackbuck/LEK_ANNOTATION/still_images/frame588.jpg,1230,932,1245,949,1237.5,940.5,1080,1920,17,15,0,0.64453125,0.8708333333333333,0.0078125,0.01574074074074074
/home/dexter/Desktop/blackbuck/LEK_ANNOTATION/still_images/frame588.jpg,1260,896,1281,917,1270.5,906.5,1080,1920,21,21,0,0.66171875,0.8393518518518519,0.0109375,0.019444444444444445
/home/dexter/Desktop/blackbuck/LEK_ANNOTATION/still_images/frame588.jpg,1327,809,1346,825,1336.5,817.0,1080,1920,16,19,0,0.69609375,0.7564814814814815,0.009895833333333333,0.014814814814814815
/home/dexter/Desktop/blackbuck/LEK_ANNOTATION/still_images/frame588.jpg,1359,855,1377,876,1368.0,865.5,1080,1920,21,18,0,0.7125,0.8013888888888889,0.009375,0.019444444444444445
/home/dexter/Desktop/blackbuck/LEK_ANNOTATION/still_images/frame588.jpg,1372,815,1389,834,1380.5,824.5,1080,1920,19,17,0,0.7190104166666667,0.763425925925926,0.008854166666666666,0.017592592592592594
/home/dexter/Desktop/blackbuck/LEK_ANNOTATION/still_images/frame588.jpg,1362,779,1380,797,1371.0,788.0,1080,1920,18,18,0,0.7140625,0.7296296296296296,0.009375,0.016666666666666666
/home/dexter/Desktop/blackbuck/LEK_ANNOTATION/still_images/frame588.jpg,1472,680,1497,697,1484.5,688.5,1080,1920,17,25,0,0.7731770833333333,0.6375,0.013020833333333334,0.01574074074074074
/home/dexter/Desktop/blackbuck/LEK_ANNOTATION/still_images/frame588.jpg,1500,651,1516,673,1508.0,662.0,1080,1920,22,16,0,0.7854166666666667,0.6129629629629629,0.008333333333333333,0.020370370370370372
/home/dexter/Desktop/blackbuck/LEK_ANNOTATION/still_images/frame588.jpg,1513,626,1534,648,1523.5,637.0,1080,1920,22,21,0,0.7934895833333333,0.5898148148148148,0.0109375,0.020370370370370372
/home/dexter/Desktop/blackbuck/LEK_ANNOTATION/still_images/frame588.jpg,1562,599,1592,615,1577.0,607.0,1080,1920,16,30,0,0.8213541666666667,0.562037037037037,0.015625,0.014814814814814815
/home/dexter/Desktop/blackbuck/LEK_ANNOTATION/still_images/frame588.jpg,1672,523,1702,537,1687.0,530.0,1080,1920,14,30,0,0.8786458333333333,0.49074074074074076,0.015625,0.012962962962962963
/home/dexter/Desktop/blackbuck/LEK_ANNOTATION/still_images/frame588.jpg,1801,474,1835,484,1818.0,479.0,1080,1920,10,34,0,0.946875,0.44351851851851853,0.017708333333333333,0.009259259259259259
/home/dexter/Desktop/blackbuck/LEK_ANNOTATION/still_images/frame588.jpg,1305,845,1323,868,1314.0,856.5,1080,1920,23,18,0,0.684375,0.7930555555555555,0.009375,0.021296296296296296
/home/dexter/Desktop/blackbuck/LEK_ANNOTATION/still_images/frame588.jpg,1758,491,1779,504,1768.5,497.5,1080,1920,13,21,0,0.92109375,0.46064814814814814,0.0109375,0.012037037037037037
/home/dexter/Desktop/blackbuck/LEK_ANNOTATION/still_images/frame342.jpg,579,623,591,641,585.0,632.0,1080,1920,18,12,0,0.3046875,0.5851851851851851,0.00625,0.016666666666666666
/home/dexter/Desktop/blackbuck/LEK_ANNOTATION/still_images/frame342.jpg,611,578,637,597,624.0,587.5,1080,1920,19,26,0,0.325,0.5439814814814815,0.013541666666666667,0.017592592592592594
/home/dexter/Desktop/blackbuck/LEK_ANNOTATION/still_images/frame342.jpg,652,555,677,567,664.5,561.0,1080,1920,12,25,0,0.34609375,0.5194444444444445,0.013020833333333334,0.011111111111111112
/home/dexter/Desktop/blackbuck/LEK_ANNOTATION/still_images/frame342.jpg,787,516,806,534,796.5,525.0,1080,1920,18,19,0,0.41484375,0.4861111111111111,0.009895833333333333,0.016666666666666666
/home/dexter/Desktop/blackbuck/LEK_ANNOTATION/still_images/frame342.jpg,794,411,813,437,803.5,424.0,1080,1920,26,19,0,0.41848958333333336,0.3925925925925926,0.009895833333333333,0.024074074074074074
/home/dexter/Desktop/blackbuck/LEK_ANNOTATION/still_images/frame342.jpg,843,425,867,438,855.0,431.5,1080,1920,13,24,0,0.4453125,0.399537037037037,0.0125,0.012037037037037037
/home/dexter/Desktop/blackbuck/LEK_ANNOTATION/still_images/frame342.jpg,850,368,870,384,860.0,376.0,1080,1920,16,20,0,0.4479166666666667,0.34814814814814815,0.010416666666666666,0.014814814814814815
/home/dexter/Desktop/blackbuck/LEK_ANNOTATION/still_images/frame342.jpg,948,290,969,309,958.5,299.5,1080,1920,19,21,0,0.49921875,0.2773148148148148,0.0109375,0.017592592592592594
/home/dexter/Desktop/blackbuck/LEK_ANNOTATION/still_images/frame342.jpg,1030,260,1052,275,1041.0,267.5,1080,1920,15,22,0,0.5421875,0.24768518518518517,0.011458333333333333,0.013888888888888888
/home/dexter/Desktop/blackbuck/LEK_ANNOTATION/still_images/frame342.jpg,980,715,1005,729,992.5,722.0,1080,1920,14,25,0,0.5169270833333334,0.6685185185185185,0.013020833333333334,0.012962962962962963
/home/dexter/Desktop/blackbuck/LEK_ANNOTATION/still_images/frame342.jpg,619,1016,632,1038,625.5,1027.0,1080,1920,22,13,0,0.32578125,0.950925925925926,0.0067708333333333336,0.020370370370370372
/home/dexter/Desktop/blackbuck/LEK_ANNOTATION/still_images/frame342.jpg,858,969,873,993,865.5,981.0,1080,1920,24,15,0,0.45078125,0.9083333333333333,0.0078125,0.022222222222222223
/home/dexter/Desktop/blackbuck/LEK_ANNOTATION/still_images/frame342.jpg,1132,1050,1146,1073,1139.0,1061.5,1080,1920,23,14,0,0.5932291666666667,0.9828703703703704,0.007291666666666667,0.021296296296296296
/home/dexter/Desktop/blackbuck/LEK_ANNOTATION/still_images/frame342.jpg,1152,1018,1174,1038,1163.0,1028.0,1080,1920,20,22,0,0.6057291666666667,0.9518518518518518,0.011458333333333333,0.018518518518518517
/home/dexter/Desktop/blackbuck/LEK_ANNOTATION/still_images/frame342.jpg,1202,1024,1218,1050,1210.0,1037.0,1080,1920,26,16,0,0.6302083333333334,0.9601851851851851,0.008333333333333333,0.024074074074074074
/home/dexter/Desktop/blackbuck/LEK_ANNOTATION/still_images/frame342.jpg,1176,990,1192,1009,1184.0,999.5,1080,1920,19,16,0,0.6166666666666667,0.9254629629629629,0.008333333333333333,0.017592592592592594
/home/dexter/Desktop/blackbuck/LEK_ANNOTATION/still_images/frame342.jpg,1200,946,1226,971,1213.0,958.5,1080,1920,25,26,0,0.6317708333333333,0.8875,0.013541666666666667,0.023148148148148147
/home/dexter/Desktop/blackbuck/LEK_ANNOTATION/still_images/frame342.jpg,1297,912,1327,925,1312.0,918.5,1080,1920,13,30,0,0.6833333333333333,0.850462962962963,0.015625,0.012037037037037037
/home/dexter/Desktop/blackbuck/LEK_ANNOTATION/still_images/frame342.jpg,1282,863,1298,883,1290.0,873.0,1080,1920,20,16,0,0.671875,0.8083333333333333,0.008333333333333333,0.018518518518518517
/home/dexter/Desktop/blackbuck/LEK_ANNOTATION/still_images/frame342.jpg,1317,861,1338,879,1327.5,870.0,1080,1920,18,21,0,0.69140625,0.8055555555555556,0.0109375,0.016666666666666666
/home/dexter/Desktop/blackbuck/LEK_ANNOTATION/still_images/frame342.jpg,1310,823,1328,840,1319.0,831.5,1080,1920,17,18,0,0.6869791666666667,0.7699074074074074,0.009375,0.01574074074074074
/home/dexter/Desktop/blackbuck/LEK_ANNOTATION/still_images/frame342.jpg,1409,725,1426,746,1417.5,735.5,1080,1920,21,17,0,0.73828125,0.6810185185185185,0.008854166666666666,0.019444444444444445
/home/dexter/Desktop/blackbuck/LEK_ANNOTATION/still_images/frame342.jpg,1434,711,1453,722,1443.5,716.5,1080,1920,11,19,0,0.7518229166666667,0.663425925925926,0.009895833333333333,0.010185185185185186
/home/dexter/Desktop/blackbuck/LEK_ANNOTATION/still_images/frame342.jpg,1457,692,1484,707,1470.5,699.5,1080,1920,15,27,0,0.7658854166666667,0.6476851851851851,0.0140625,0.013888888888888888
/home/dexter/Desktop/blackbuck/LEK_ANNOTATION/still_images/frame342.jpg,1502,638,1529,659,1515.5,648.5,1080,1920,21,27,0,0.7893229166666667,0.600462962962963,0.0140625,0.019444444444444445
/home/dexter/Desktop/blackbuck/LEK_ANNOTATION/still_images/frame342.jpg,1611,565,1636,580,1623.5,572.5,1080,1920,15,25,0,0.8455729166666667,0.5300925925925926,0.013020833333333334,0.013888888888888888
/home/dexter/Desktop/blackbuck/LEK_ANNOTATION/still_images/frame342.jpg,1697,511,1736,527,1716.5,519.0,1080,1920,16,39,0,0.8940104166666667,0.48055555555555557,0.0203125,0.014814814814814815
/home/dexter/Desktop/blackbuck/LEK_ANNOTATION/still_images/frame342.jpg,1846,277,1869,299,1857.5,288.0,1080,1920,22,23,0,0.9674479166666666,0.26666666666666666,0.011979166666666667,0.020370370370370372
/home/dexter/Desktop/blackbuck/LEK_ANNOTATION/still_images/frame342.jpg,1886,240,1911,262,1898.5,251.0,1080,1920,22,25,0,0.9888020833333333,0.2324074074074074,0.013020833333333334,0.020370370370370372
/home/dexter/Desktop/blackbuck/LEK_ANNOTATION/still_images/frame342.jpg,1888,345,1914,367,1901.0,356.0,1080,1920,22,26,0,0.9901041666666667,0.3296296296296296,0.013541666666666667,0.020370370370370372
/home/dexter/Desktop/blackbuck/LEK_ANNOTATION/still_images/frame572.jpg,619,576,640,589,629.5,582.5,1080,1920,13,21,0,0.32786458333333335,0.5393518518518519,0.0109375,0.012037037037037037
/home/dexter/Desktop/blackbuck/LEK_ANNOTATION/still_images/frame572.jpg,667,536,687,549,677.0,542.5,1080,1920,13,20,0,0.35260416666666666,0.5023148148148148,0.010416666666666666,0.012037037037037037
/home/dexter/Desktop/blackbuck/LEK_ANNOTATION/still_images/frame572.jpg,583,616,596,638,589.5,627.0,1080,1920,22,13,0,0.30703125,0.5805555555555556,0.0067708333333333336,0.020370370370370372
/home/dexter/Desktop/blackbuck/LEK_ANNOTATION/still_images/frame572.jpg,718,535,743,553,730.5,544.0,1080,1920,18,25,0,0.38046875,0.5037037037037037,0.013020833333333334,0.016666666666666666
/home/dexter/Desktop/blackbuck/LEK_ANNOTATION/still_images/frame572.jpg,827,473,849,488,838.0,480.5,1080,1920,15,22,0,0.43645833333333334,0.4449074074074074,0.011458333333333333,0.013888888888888888
/home/dexter/Desktop/blackbuck/LEK_ANNOTATION/still_images/frame572.jpg,848,366,865,389,856.5,377.5,1080,1920,23,17,0,0.44609375,0.34953703703703703,0.008854166666666666,0.021296296296296296
/home/dexter/Desktop/blackbuck/LEK_ANNOTATION/still_images/frame572.jpg,897,393,915,409,906.0,401.0,1080,1920,16,18,0,0.471875,0.3712962962962963,0.009375,0.014814814814814815
/home/dexter/Desktop/blackbuck/LEK_ANNOTATION/still_images/frame572.jpg,902,326,927,340,914.5,333.0,1080,1920,14,25,0,0.47630208333333335,0.30833333333333335,0.013020833333333334,0.012962962962962963
/home/dexter/Desktop/blackbuck/LEK_ANNOTATION/still_images/frame572.jpg,1015,263,1038,276,1026.5,269.5,1080,1920,13,23,0,0.5346354166666667,0.24953703703703703,0.011979166666666667,0.012037037037037037
/home/dexter/Desktop/blackbuck/LEK_ANNOTATION/still_images/frame572.jpg,1095,240,1124,258,1109.5,249.0,1080,1920,18,29,0,0.5778645833333333,0.23055555555555557,0.015104166666666667,0.016666666666666666
/home/dexter/Desktop/blackbuck/LEK_ANNOTATION/still_images/frame572.jpg,1033,673,1057,693,1045.0,683.0,1080,1920,20,24,0,0.5442708333333334,0.6324074074074074,0.0125,0.018518518518518517
/home/dexter/Desktop/blackbuck/LEK_ANNOTATION/still_images/frame572.jpg,666,985,692,1003,679.0,994.0,1080,1920,18,26,0,0.3536458333333333,0.9203703703703704,0.013541666666666667,0.016666666666666666
/home/dexter/Desktop/blackbuck/LEK_ANNOTATION/still_images/frame572.jpg,864,965,881,992,872.5,978.5,1080,1920,27,17,0,0.4544270833333333,0.9060185185185186,0.008854166666666666,0.025
/home/dexter/Desktop/blackbuck/LEK_ANNOTATION/still_images/frame572.jpg,1121,1057,1141,1073,1131.0,1065.0,1080,1920,16,20,0,0.5890625,0.9861111111111112,0.010416666666666666,0.014814814814814815
/home/dexter/Desktop/blackbuck/LEK_ANNOTATION/still_images/frame572.jpg,1137,1040,1155,1060,1146.0,1050.0,1080,1920,20,18,0,0.596875,0.9722222222222222,0.009375,0.018518518518518517
/home/dexter/Desktop/blackbuck/LEK_ANNOTATION/still_images/frame572.jpg,1149,1022,1173,1044,1161.0,1033.0,1080,1920,22,24,0,0.6046875,0.9564814814814815,0.0125,0.020370370370370372
/home/dexter/Desktop/blackbuck/LEK_ANNOTATION/still_images/frame572.jpg,1180,996,1198,1014,1189.0,1005.0,1080,1920,18,18,0,0.6192708333333333,0.9305555555555556,0.009375,0.016666666666666666
/home/dexter/Desktop/blackbuck/LEK_ANNOTATION/still_images/frame572.jpg,1208,953,1227,976,1217.5,964.5,1080,1920,23,19,0,0.6341145833333334,0.8930555555555556,0.009895833333333333,0.021296296296296296
/home/dexter/Desktop/blackbuck/LEK_ANNOTATION/still_images/frame572.jpg,1239,982,1263,997,1251.0,989.5,1080,1920,15,24,0,0.6515625,0.9162037037037037,0.0125,0.013888888888888888
/home/dexter/Desktop/blackbuck/LEK_ANNOTATION/still_images/frame572.jpg,1224,935,1241,955,1232.5,945.0,1080,1920,20,17,0,0.6419270833333334,0.875,0.008854166666666666,0.018518518518518517
/home/dexter/Desktop/blackbuck/LEK_ANNOTATION/still_images/frame572.jpg,1254,900,1278,918,1266.0,909.0,1080,1920,18,24,0,0.659375,0.8416666666666667,0.0125,0.016666666666666666
/home/dexter/Desktop/blackbuck/LEK_ANNOTATION/still_images/frame572.jpg,1300,850,1320,875,1310.0,862.5,1080,1920,25,20,0,0.6822916666666666,0.7986111111111112,0.010416666666666666,0.023148148148148147
/home/dexter/Desktop/blackbuck/LEK_ANNOTATION/still_images/frame572.jpg,1354,863,1377,884,1365.5,873.5,1080,1920,21,23,0,0.7111979166666667,0.8087962962962963,0.011979166666666667,0.019444444444444445
/home/dexter/Desktop/blackbuck/LEK_ANNOTATION/still_images/frame572.jpg,1325,813,1347,828,1336.0,820.5,1080,1920,15,22,0,0.6958333333333333,0.7597222222222222,0.011458333333333333,0.013888888888888888
/home/dexter/Desktop/blackbuck/LEK_ANNOTATION/still_images/frame572.jpg,1369,821,1388,838,1378.5,829.5,1080,1920,17,19,0,0.71796875,0.7680555555555556,0.009895833333333333,0.01574074074074074
/home/dexter/Desktop/blackbuck/LEK_ANNOTATION/still_images/frame572.jpg,1359,782,1382,802,1370.5,792.0,1080,1920,20,23,0,0.7138020833333333,0.7333333333333333,0.011979166666666667,0.018518518518518517
/home/dexter/Desktop/blackbuck/LEK_ANNOTATION/still_images/frame572.jpg,1465,684,1493,700,1479.0,692.0,1080,1920,16,28,0,0.7703125,0.6407407407407407,0.014583333333333334,0.014814814814814815
/home/dexter/Desktop/blackbuck/LEK_ANNOTATION/still_images/frame572.jpg,1496,656,1513,677,1504.5,666.5,1080,1920,21,17,0,0.78359375,0.6171296296296296,0.008854166666666666,0.019444444444444445
/home/dexter/Desktop/blackbuck/LEK_ANNOTATION/still_images/frame572.jpg,1510,629,1536,654,1523.0,641.5,1080,1920,25,26,0,0.7932291666666667,0.5939814814814814,0.013541666666666667,0.023148148148148147
/home/dexter/Desktop/blackbuck/LEK_ANNOTATION/still_images/frame572.jpg,1559,601,1586,616,1572.5,608.5,1080,1920,15,27,0,0.8190104166666666,0.5634259259259259,0.0140625,0.013888888888888888
/home/dexter/Desktop/blackbuck/LEK_ANNOTATION/still_images/frame572.jpg,1672,526,1692,543,1682.0,534.5,1080,1920,17,20,0,0.8760416666666667,0.4949074074074074,0.010416666666666666,0.01574074074074074
/home/dexter/Desktop/blackbuck/LEK_ANNOTATION/still_images/frame572.jpg,1753,492,1777,504,1765.0,498.0,1080,1920,12,24,0,0.9192708333333334,0.46111111111111114,0.0125,0.011111111111111112
/home/dexter/Desktop/blackbuck/LEK_ANNOTATION/still_images/frame572.jpg,1798,474,1824,490,1811.0,482.0,1080,1920,16,26,0,0.9432291666666667,0.4462962962962963,0.013541666666666667,0.014814814814814815
/home/dexter/Desktop/blackbuck/LEK_ANNOTATION/still_images/frame612.jpg,626,569,643,582,634.5,575.5,1080,1920,13,17,0,0.33046875,0.5328703703703703,0.008854166666666666,0.012037037037037037
/home/dexter/Desktop/blackbuck/LEK_ANNOTATION/still_images/frame612.jpg,676,529,696,542,686.0,535.5,1080,1920,13,20,0,0.3572916666666667,0.49583333333333335,0.010416666666666666,0.012037037037037037
/home/dexter/Desktop/blackbuck/LEK_ANNOTATION/still_images/frame612.jpg,730,534,750,549,740.0,541.5,1080,1920,15,20,0,0.3854166666666667,0.5013888888888889,0.010416666666666666,0.013888888888888888
/home/dexter/Desktop/blackbuck/LEK_ANNOTATION/still_images/frame612.jpg,836,470,855,483,845.5,476.5,1080,1920,13,19,0,0.44036458333333334,0.4412037037037037,0.009895833333333333,0.012037037037037037
/home/dexter/Desktop/blackbuck/LEK_ANNOTATION/still_images/frame612.jpg,862,359,880,378,871.0,368.5,1080,1920,19,18,0,0.45364583333333336,0.34120370370370373,0.009375,0.017592592592592594
/home/dexter/Desktop/blackbuck/LEK_ANNOTATION/still_images/frame612.jpg,917,319,936,334,926.5,326.5,1080,1920,15,19,0,0.4825520833333333,0.3023148148148148,0.009895833333333333,0.013888888888888888
/home/dexter/Desktop/blackbuck/LEK_ANNOTATION/still_images/frame612.jpg,902,392,921,407,911.5,399.5,1080,1920,15,19,0,0.4747395833333333,0.3699074074074074,0.009895833333333333,0.013888888888888888
/home/dexter/Desktop/blackbuck/LEK_ANNOTATION/still_images/frame612.jpg,681,980,702,996,691.5,988.0,1080,1920,16,21,0,0.36015625,0.9148148148148149,0.0109375,0.014814814814814815
/home/dexter/Desktop/blackbuck/LEK_ANNOTATION/still_images/frame612.jpg,1026,257,1048,276,1037.0,266.5,1080,1920,19,22,0,0.5401041666666667,0.24675925925925926,0.011458333333333333,0.017592592592592594
/home/dexter/Desktop/blackbuck/LEK_ANNOTATION/still_images/frame612.jpg,1110,240,1135,257,1122.5,248.5,1080,1920,17,25,0,0.5846354166666666,0.2300925925925926,0.013020833333333334,0.01574074074074074
/home/dexter/Desktop/blackbuck/LEK_ANNOTATION/still_images/frame612.jpg,866,966,879,994,872.5,980.0,1080,1920,28,13,0,0.4544270833333333,0.9074074074074074,0.0067708333333333336,0.025925925925925925
/home/dexter/Desktop/blackbuck/LEK_ANNOTATION/still_images/frame612.jpg,1040,666,1063,686,1051.5,676.0,1080,1920,20,23,0,0.54765625,0.6259259259259259,0.011979166666666667,0.018518518518518517
/home/dexter/Desktop/blackbuck/LEK_ANNOTATION/still_images/frame612.jpg,1113,1067,1132,1082,1122.5,1074.5,1080,1920,15,19,0,0.5846354166666666,0.9949074074074075,0.009895833333333333,0.013888888888888888
/home/dexter/Desktop/blackbuck/LEK_ANNOTATION/still_images/frame612.jpg,1131,1043,1144,1064,1137.5,1053.5,1080,1920,21,13,0,0.5924479166666666,0.975462962962963,0.0067708333333333336,0.019444444444444445
/home/dexter/Desktop/blackbuck/LEK_ANNOTATION/still_images/frame612.jpg,1144,1033,1164,1055,1154.0,1044.0,1080,1920,22,20,0,0.6010416666666667,0.9666666666666667,0.010416666666666666,0.020370370370370372
/home/dexter/Desktop/blackbuck/LEK_ANNOTATION/still_images/frame612.jpg,1156,1015,1183,1035,1169.5,1025.0,1080,1920,20,27,0,0.6091145833333333,0.9490740740740741,0.0140625,0.018518518518518517
/home/dexter/Desktop/blackbuck/LEK_ANNOTATION/still_images/frame612.jpg,1187,987,1208,1005,1197.5,996.0,1080,1920,18,21,0,0.6236979166666666,0.9222222222222223,0.0109375,0.016666666666666666
/home/dexter/Desktop/blackbuck/LEK_ANNOTATION/still_images/frame612.jpg,1248,976,1271,995,1259.5,985.5,1080,1920,19,23,0,0.6559895833333333,0.9125,0.011979166666666667,0.017592592592592594
/home/dexter/Desktop/blackbuck/LEK_ANNOTATION/still_images/frame612.jpg,1216,949,1236,966,1226.0,957.5,1080,1920,17,20,0,0.6385416666666667,0.8865740740740741,0.010416666666666666,0.01574074074074074
/home/dexter/Desktop/blackbuck/LEK_ANNOTATION/still_images/frame612.jpg,1230,925,1252,945,1241.0,935.0,1080,1920,20,22,0,0.6463541666666667,0.8657407407407407,0.011458333333333333,0.018518518518518517
/home/dexter/Desktop/blackbuck/LEK_ANNOTATION/still_images/frame612.jpg,1266,895,1287,912,1276.5,903.5,1080,1920,17,21,0,0.66484375,0.836574074074074,0.0109375,0.01574074074074074
/home/dexter/Desktop/blackbuck/LEK_ANNOTATION/still_images/frame612.jpg,1360,854,1381,880,1370.5,867.0,1080,1920,26,21,0,0.7138020833333333,0.8027777777777778,0.0109375,0.024074074074074074
/home/dexter/Desktop/blackbuck/LEK_ANNOTATION/still_images/frame612.jpg,1332,807,1352,823,1342.0,815.0,1080,1920,16,20,0,0.6989583333333333,0.7546296296296297,0.010416666666666666,0.014814814814814815
/home/dexter/Desktop/blackbuck/LEK_ANNOTATION/still_images/frame612.jpg,1375,811,1393,832,1384.0,821.5,1080,1920,21,18,0,0.7208333333333333,0.7606481481481482,0.009375,0.019444444444444445
/home/dexter/Desktop/blackbuck/LEK_ANNOTATION/still_images/frame612.jpg,1364,774,1383,800,1373.5,787.0,1080,1920,26,19,0,0.7153645833333333,0.7287037037037037,0.009895833333333333,0.024074074074074074
/home/dexter/Desktop/blackbuck/LEK_ANNOTATION/still_images/frame612.jpg,1479,676,1504,694,1491.5,685.0,1080,1920,18,25,0,0.7768229166666667,0.6342592592592593,0.013020833333333334,0.016666666666666666
/home/dexter/Desktop/blackbuck/LEK_ANNOTATION/still_images/frame612.jpg,1503,650,1518,672,1510.5,661.0,1080,1920,22,15,0,0.78671875,0.612037037037037,0.0078125,0.020370370370370372
/home/dexter/Desktop/blackbuck/LEK_ANNOTATION/still_images/frame612.jpg,1520,622,1541,647,1530.5,634.5,1080,1920,25,21,0,0.7971354166666667,0.5875,0.0109375,0.023148148148148147
/home/dexter/Desktop/blackbuck/LEK_ANNOTATION/still_images/frame612.jpg,1569,594,1601,614,1585.0,604.0,1080,1920,20,32,0,0.8255208333333334,0.5592592592592592,0.016666666666666666,0.018518518518518517
/home/dexter/Desktop/blackbuck/LEK_ANNOTATION/still_images/frame612.jpg,1674,518,1703,537,1688.5,527.5,1080,1920,19,29,0,0.8794270833333333,0.48842592592592593,0.015104166666666667,0.017592592592592594
/home/dexter/Desktop/blackbuck/LEK_ANNOTATION/still_images/frame612.jpg,1761,491,1781,505,1771.0,498.0,1080,1920,14,20,0,0.9223958333333333,0.46111111111111114,0.010416666666666666,0.012962962962962963
/home/dexter/Desktop/blackbuck/LEK_ANNOTATION/still_images/frame612.jpg,1810,474,1840,486,1825.0,480.0,1080,1920,12,30,0,0.9505208333333334,0.4444444444444444,0.015625,0.011111111111111112
/home/dexter/Desktop/blackbuck/LEK_ANNOTATION/still_images/frame454.jpg,598,596,613,615,605.5,605.5,1080,1920,19,15,0,0.31536458333333334,0.5606481481481481,0.0078125,0.017592592592592594
/home/dexter/Desktop/blackbuck/LEK_ANNOTATION/still_images/frame454.jpg,638,558,661,570,649.5,564.0,1080,1920,12,23,0,0.33828125,0.5222222222222223,0.011979166666666667,0.011111111111111112
/home/dexter/Desktop/blackbuck/LEK_ANNOTATION/still_images/frame454.jpg,684,546,708,559,696.0,552.5,1080,1920,13,24,0,0.3625,0.5115740740740741,0.0125,0.012037037037037037
/home/dexter/Desktop/blackbuck/LEK_ANNOTATION/still_images/frame454.jpg,637,1000,657,1014,647.0,1007.0,1080,1920,14,20,0,0.33697916666666666,0.9324074074074075,0.010416666666666666,0.012962962962962963
/home/dexter/Desktop/blackbuck/LEK_ANNOTATION/still_images/frame454.jpg,863,967,876,993,869.5,980.0,1080,1920,26,13,0,0.45286458333333335,0.9074074074074074,0.0067708333333333336,0.024074074074074074
/home/dexter/Desktop/blackbuck/LEK_ANNOTATION/still_images/frame454.jpg,804,498,827,515,815.5,506.5,1080,1920,17,23,0,0.42473958333333334,0.4689814814814815,0.011979166666666667,0.01574074074074074
/home/dexter/Desktop/blackbuck/LEK_ANNOTATION/still_images/frame454.jpg,816,389,839,409,827.5,399.0,1080,1920,20,23,0,0.4309895833333333,0.36944444444444446,0.011979166666666667,0.018518518518518517
/home/dexter/Desktop/blackbuck/LEK_ANNOTATION/still_images/frame454.jpg,871,408,896,422,883.5,415.0,1080,1920,14,25,0,0.46015625,0.38425925925925924,0.013020833333333334,0.012962962962962963
/home/dexter/Desktop/blackbuck/LEK_ANNOTATION/still_images/frame454.jpg,877,342,894,362,885.5,352.0,1080,1920,20,17,0,0.46119791666666665,0.32592592592592595,0.008854166666666666,0.018518518518518517
/home/dexter/Desktop/blackbuck/LEK_ANNOTATION/still_images/frame454.jpg,975,280,1005,294,990.0,287.0,1080,1920,14,30,0,0.515625,0.2657407407407407,0.015625,0.012962962962962963
/home/dexter/Desktop/blackbuck/LEK_ANNOTATION/still_images/frame454.jpg,1062,250,1086,267,1074.0,258.5,1080,1920,17,24,0,0.559375,0.23935185185185184,0.0125,0.01574074074074074
/home/dexter/Desktop/blackbuck/LEK_ANNOTATION/still_images/frame454.jpg,1007,700,1031,711,1019.0,705.5,1080,1920,11,24,0,0.5307291666666667,0.6532407407407408,0.0125,0.010185185185185186
/home/dexter/Desktop/blackbuck/LEK_ANNOTATION/still_images/frame454.jpg,1125,1047,1144,1067,1134.5,1057.0,1080,1920,20,19,0,0.5908854166666667,0.9787037037037037,0.009895833333333333,0.018518518518518517
/home/dexter/Desktop/blackbuck/LEK_ANNOTATION/still_images/frame454.jpg,1148,1019,1170,1041,1159.0,1030.0,1080,1920,22,22,0,0.6036458333333333,0.9537037037037037,0.011458333333333333,0.020370370370370372
/home/dexter/Desktop/blackbuck/LEK_ANNOTATION/still_images/frame454.jpg,1180,985,1200,1009,1190.0,997.0,1080,1920,24,20,0,0.6197916666666666,0.9231481481481482,0.010416666666666666,0.022222222222222223
/home/dexter/Desktop/blackbuck/LEK_ANNOTATION/still_images/frame454.jpg,1218,1001,1238,1025,1228.0,1013.0,1080,1920,24,20,0,0.6395833333333333,0.937962962962963,0.010416666666666666,0.022222222222222223
/home/dexter/Desktop/blackbuck/LEK_ANNOTATION/still_images/frame454.jpg,1201,965,1216,983,1208.5,974.0,1080,1920,18,15,0,0.6294270833333333,0.9018518518518519,0.0078125,0.016666666666666666
/home/dexter/Desktop/blackbuck/LEK_ANNOTATION/still_images/frame454.jpg,1230,923,1246,943,1238.0,933.0,1080,1920,20,16,0,0.6447916666666667,0.8638888888888889,0.008333333333333333,0.018518518518518517
/home/dexter/Desktop/blackbuck/LEK_ANNOTATION/still_images/frame454.jpg,1276,882,1300,902,1288.0,892.0,1080,1920,20,24,0,0.6708333333333333,0.825925925925926,0.0125,0.018518518518518517
/home/dexter/Desktop/blackbuck/LEK_ANNOTATION/still_images/frame454.jpg,1330,883,1347,906,1338.5,894.5,1080,1920,23,17,0,0.6971354166666667,0.8282407407407407,0.008854166666666666,0.021296296296296296
/home/dexter/Desktop/blackbuck/LEK_ANNOTATION/still_images/frame454.jpg,1301,832,1318,858,1309.5,845.0,1080,1920,26,17,0,0.68203125,0.7824074074074074,0.008854166666666666,0.024074074074074074
/home/dexter/Desktop/blackbuck/LEK_ANNOTATION/still_images/frame454.jpg,1339,844,1362,863,1350.5,853.5,1080,1920,19,23,0,0.7033854166666667,0.7902777777777777,0.011979166666666667,0.017592592592592594
/home/dexter/Desktop/blackbuck/LEK_ANNOTATION/still_images/frame454.jpg,1333,803,1355,823,1344.0,813.0,1080,1920,20,22,0,0.7,0.7527777777777778,0.011458333333333333,0.018518518518518517
/home/dexter/Desktop/blackbuck/LEK_ANNOTATION/still_images/frame454.jpg,1437,702,1458,723,1447.5,712.5,1080,1920,21,21,0,0.75390625,0.6597222222222222,0.0109375,0.019444444444444445
/home/dexter/Desktop/blackbuck/LEK_ANNOTATION/still_images/frame454.jpg,1467,684,1487,699,1477.0,691.5,1080,1920,15,20,0,0.7692708333333333,0.6402777777777777,0.010416666666666666,0.013888888888888888
/home/dexter/Desktop/blackbuck/LEK_ANNOTATION/still_images/frame454.jpg,1487,657,1511,684,1499.0,670.5,1080,1920,27,24,0,0.7807291666666667,0.6208333333333333,0.0125,0.025
/home/dexter/Desktop/blackbuck/LEK_ANNOTATION/still_images/frame454.jpg,1527,615,1556,634,1541.5,624.5,1080,1920,19,29,0,0.8028645833333333,0.5782407407407407,0.015104166666666667,0.017592592592592594
/home/dexter/Desktop/blackbuck/LEK_ANNOTATION/still_images/frame454.jpg,1639,545,1664,561,1651.5,553.0,1080,1920,16,25,0,0.86015625,0.5120370370370371,0.013020833333333334,0.014814814814814815
/home/dexter/Desktop/blackbuck/LEK_ANNOTATION/still_images/frame454.jpg,1729,499,1753,513,1741.0,506.0,1080,1920,14,24,0,0.9067708333333333,0.4685185185185185,0.0125,0.012962962962962963
/home/dexter/Desktop/blackbuck/LEK_ANNOTATION/still_images/frame454.jpg,1761,484,1787,498,1774.0,491.0,1080,1920,14,26,0,0.9239583333333333,0.4546296296296296,0.013541666666666667,0.012962962962962963
/home/dexter/Desktop/blackbuck/LEK_ANNOTATION/still_images/frame454.jpg,1871,250,1893,273,1882.0,261.5,1080,1920,23,22,0,0.9802083333333333,0.24212962962962964,0.011458333333333333,0.021296296296296296
/home/dexter/Desktop/blackbuck/LEK_ANNOTATION/still_images/frame162.jpg,543,660,557,681,550.0,670.5,1080,1920,21,14,0,0.2864583333333333,0.6208333333333333,0.007291666666666667,0.019444444444444445
/home/dexter/Desktop/blackbuck/LEK_ANNOTATION/still_images/frame162.jpg,578,617,596,638,587.0,627.5,1080,1920,21,18,0,0.30572916666666666,0.5810185185185185,0.009375,0.019444444444444445
/home/dexter/Desktop/blackbuck/LEK_ANNOTATION/still_images/frame162.jpg,613,573,633,597,623.0,585.0,1080,1920,24,20,0,0.32447916666666665,0.5416666666666666,0.010416666666666666,0.022222222222222223
/home/dexter/Desktop/blackbuck/LEK_ANNOTATION/still_images/frame162.jpg,751,545,773,564,762.0,554.5,1080,1920,19,22,0,0.396875,0.513425925925926,0.011458333333333333,0.017592592592592594
/home/dexter/Desktop/blackbuck/LEK_ANNOTATION/still_images/frame162.jpg,756,460,774,481,765.0,470.5,1080,1920,21,18,0,0.3984375,0.4356481481481482,0.009375,0.019444444444444445
/home/dexter/Desktop/blackbuck/LEK_ANNOTATION/still_images/frame162.jpg,791,440,814,455,802.5,447.5,1080,1920,15,23,0,0.41796875,0.41435185185185186,0.011979166666666667,0.013888888888888888
/home/dexter/Desktop/blackbuck/LEK_ANNOTATION/still_images/frame162.jpg,812,398,830,420,821.0,409.0,1080,1920,22,18,0,0.4276041666666667,0.3787037037037037,0.009375,0.020370370370370372
/home/dexter/Desktop/blackbuck/LEK_ANNOTATION/still_images/frame162.jpg,909,323,936,344,922.5,333.5,1080,1920,21,27,0,0.48046875,0.3087962962962963,0.0140625,0.019444444444444445
/home/dexter/Desktop/blackbuck/LEK_ANNOTATION/still_images/frame162.jpg,984,264,1009,285,996.5,274.5,1080,1920,21,25,0,0.5190104166666667,0.25416666666666665,0.013020833333333334,0.019444444444444445
/home/dexter/Desktop/blackbuck/LEK_ANNOTATION/still_images/frame162.jpg,611,1019,631,1039,621.0,1029.0,1080,1920,20,20,0,0.3234375,0.9527777777777777,0.010416666666666666,0.018518518518518517
/home/dexter/Desktop/blackbuck/LEK_ANNOTATION/still_images/frame162.jpg,852,970,868,1002,860.0,986.0,1080,1920,32,16,0,0.4479166666666667,0.912962962962963,0.008333333333333333,0.02962962962962963
/home/dexter/Desktop/blackbuck/LEK_ANNOTATION/still_images/frame162.jpg,930,732,957,753,943.5,742.5,1080,1920,21,27,0,0.49140625,0.6875,0.0140625,0.019444444444444445
/home/dexter/Desktop/blackbuck/LEK_ANNOTATION/still_images/frame162.jpg,1141,1028,1159,1046,1150.0,1037.0,1080,1920,18,18,0,0.5989583333333334,0.9601851851851851,0.009375,0.016666666666666666
/home/dexter/Desktop/blackbuck/LEK_ANNOTATION/still_images/frame162.jpg,1124,1062,1141,1078,1132.5,1070.0,1080,1920,16,17,0,0.58984375,0.9907407407407407,0.008854166666666666,0.014814814814814815
/home/dexter/Desktop/blackbuck/LEK_ANNOTATION/still_images/frame162.jpg,1194,1037,1210,1066,1202.0,1051.5,1080,1920,29,16,0,0.6260416666666667,0.9736111111111111,0.008333333333333333,0.026851851851851852
/home/dexter/Desktop/blackbuck/LEK_ANNOTATION/still_images/frame162.jpg,1169,991,1191,1016,1180.0,1003.5,1080,1920,25,22,0,0.6145833333333334,0.9291666666666667,0.011458333333333333,0.023148148148148147
/home/dexter/Desktop/blackbuck/LEK_ANNOTATION/still_images/frame162.jpg,1258,936,1280,958,1269.0,947.0,1080,1920,22,22,0,0.6609375,0.8768518518518519,0.011458333333333333,0.020370370370370372
/home/dexter/Desktop/blackbuck/LEK_ANNOTATION/still_images/frame162.jpg,1252,896,1272,918,1262.0,907.0,1080,1920,22,20,0,0.6572916666666667,0.8398148148148148,0.010416666666666666,0.020370370370370372
/home/dexter/Desktop/blackbuck/LEK_ANNOTATION/still_images/frame162.jpg,1285,896,1306,914,1295.5,905.0,1080,1920,18,21,0,0.6747395833333333,0.8379629629629629,0.0109375,0.016666666666666666
/home/dexter/Desktop/blackbuck/LEK_ANNOTATION/still_images/frame162.jpg,1285,862,1303,885,1294.0,873.5,1080,1920,23,18,0,0.6739583333333333,0.8087962962962963,0.009375,0.021296296296296296
/home/dexter/Desktop/blackbuck/LEK_ANNOTATION/still_images/frame162.jpg,1362,764,1387,783,1374.5,773.5,1080,1920,19,25,0,0.7158854166666667,0.7162037037037037,0.013020833333333334,0.017592592592592594
/home/dexter/Desktop/blackbuck/LEK_ANNOTATION/still_images/frame162.jpg,1388,746,1410,760,1399.0,753.0,1080,1920,14,22,0,0.7286458333333333,0.6972222222222222,0.011458333333333333,0.012962962962962963
/home/dexter/Desktop/blackbuck/LEK_ANNOTATION/still_images/frame162.jpg,1414,719,1441,737,1427.5,728.0,1080,1920,18,27,0,0.7434895833333334,0.674074074074074,0.0140625,0.016666666666666666
/home/dexter/Desktop/blackbuck/LEK_ANNOTATION/still_images/frame162.jpg,1471,678,1496,701,1483.5,689.5,1080,1920,23,25,0,0.77265625,0.638425925925926,0.013020833333333334,0.021296296296296296
/home/dexter/Desktop/blackbuck/LEK_ANNOTATION/still_images/frame162.jpg,1569,591,1594,611,1581.5,601.0,1080,1920,20,25,0,0.8236979166666667,0.5564814814814815,0.013020833333333334,0.018518518518518517
/home/dexter/Desktop/blackbuck/LEK_ANNOTATION/still_images/frame162.jpg,1656,532,1687,548,1671.5,540.0,1080,1920,16,31,0,0.8705729166666667,0.5,0.016145833333333335,0.014814814814814815
/home/dexter/Desktop/blackbuck/LEK_ANNOTATION/still_images/frame162.jpg,1732,493,1756,511,1744.0,502.0,1080,1920,18,24,0,0.9083333333333333,0.4648148148148148,0.0125,0.016666666666666666
/home/dexter/Desktop/blackbuck/LEK_ANNOTATION/still_images/frame162.jpg,1842,376,1875,399,1858.5,387.5,1080,1920,23,33,0,0.96796875,0.3587962962962963,0.0171875,0.021296296296296296
/home/dexter/Desktop/blackbuck/LEK_ANNOTATION/still_images/frame162.jpg,1810,320,1837,340,1823.5,330.0,1080,1920,20,27,0,0.9497395833333333,0.3055555555555556,0.0140625,0.018518518518518517
/home/dexter/Desktop/blackbuck/LEK_ANNOTATION/still_images/frame162.jpg,1849,279,1870,299,1859.5,289.0,1080,1920,20,21,0,0.9684895833333333,0.2675925925925926,0.0109375,0.018518518518518517
/home/dexter/Desktop/blackbuck/LEK_ANNOTATION/still_images/frame388.jpg,585,612,603,633,594.0,622.5,1080,1920,21,18,0,0.309375,0.5763888888888888,0.009375,0.019444444444444445
/home/dexter/Desktop/blackbuck/LEK_ANNOTATION/still_images/frame388.jpg,625,566,640,587,632.5,576.5,1080,1920,21,15,0,0.3294270833333333,0.5337962962962963,0.0078125,0.019444444444444445
/home/dexter/Desktop/blackbuck/LEK_ANNOTATION/still_images/frame388.jpg,669,549,691,564,680.0,556.5,1080,1920,15,22,0,0.3541666666666667,0.5152777777777777,0.011458333333333333,0.013888888888888888
/home/dexter/Desktop/blackbuck/LEK_ANNOTATION/still_images/frame388.jpg,793,506,810,529,801.5,517.5,1080,1920,23,17,0,0.41744791666666664,0.4791666666666667,0.008854166666666666,0.021296296296296296
/home/dexter/Desktop/blackbuck/LEK_ANNOTATION/still_images/frame388.jpg,805,404,819,426,812.0,415.0,1080,1920,22,14,0,0.42291666666666666,0.38425925925925924,0.007291666666666667,0.020370370370370372
/home/dexter/Desktop/blackbuck/LEK_ANNOTATION/still_images/frame388.jpg,855,419,877,431,866.0,425.0,1080,1920,12,22,0,0.4510416666666667,0.39351851851851855,0.011458333333333333,0.011111111111111112
/home/dexter/Desktop/blackbuck/LEK_ANNOTATION/still_images/frame388.jpg,865,361,882,377,873.5,369.0,1080,1920,16,17,0,0.4549479166666667,0.3416666666666667,0.008854166666666666,0.014814814814814815
/home/dexter/Desktop/blackbuck/LEK_ANNOTATION/still_images/frame388.jpg,959,289,984,305,971.5,297.0,1080,1920,16,25,0,0.5059895833333333,0.275,0.013020833333333334,0.014814814814814815
/home/dexter/Desktop/blackbuck/LEK_ANNOTATION/still_images/frame388.jpg,1040,256,1068,269,1054.0,262.5,1080,1920,13,28,0,0.5489583333333333,0.24305555555555555,0.014583333333333334,0.012037037037037037
/home/dexter/Desktop/blackbuck/LEK_ANNOTATION/still_images/frame388.jpg,621,1005,639,1029,630.0,1017.0,1080,1920,24,18,0,0.328125,0.9416666666666667,0.009375,0.022222222222222223
/home/dexter/Desktop/blackbuck/LEK_ANNOTATION/still_images/frame388.jpg,859,967,873,993,866.0,980.0,1080,1920,26,14,0,0.4510416666666667,0.9074074074074074,0.007291666666666667,0.024074074074074074
/home/dexter/Desktop/blackbuck/LEK_ANNOTATION/still_images/frame388.jpg,841,1013,858,1027,849.5,1020.0,1080,1920,14,17,0,0.44244791666666666,0.9444444444444444,0.008854166666666666,0.012962962962962963
/home/dexter/Desktop/blackbuck/LEK_ANNOTATION/still_images/frame388.jpg,994,710,1015,725,1004.5,717.5,1080,1920,15,21,0,0.5231770833333333,0.6643518518518519,0.0109375,0.013888888888888888
/home/dexter/Desktop/blackbuck/LEK_ANNOTATION/still_images/frame388.jpg,1108,1060,1131,1078,1119.5,1069.0,1080,1920,18,23,0,0.5830729166666667,0.9898148148148148,0.011979166666666667,0.016666666666666666
/home/dexter/Desktop/blackbuck/LEK_ANNOTATION/still_images/frame388.jpg,1141,1036,1153,1059,1147.0,1047.5,1080,1920,23,12,0,0.5973958333333333,0.9699074074074074,0.00625,0.021296296296296296
/home/dexter/Desktop/blackbuck/LEK_ANNOTATION/still_images/frame388.jpg,1167,1005,1187,1025,1177.0,1015.0,1080,1920,20,20,0,0.6130208333333333,0.9398148148148148,0.010416666666666666,0.018518518518518517
/home/dexter/Desktop/blackbuck/LEK_ANNOTATION/still_images/frame388.jpg,1210,1015,1222,1037,1216.0,1026.0,1080,1920,22,12,0,0.6333333333333333,0.95,0.00625,0.020370370370370372
/home/dexter/Desktop/blackbuck/LEK_ANNOTATION/still_images/frame388.jpg,1184,979,1203,998,1193.5,988.5,1080,1920,19,19,0,0.6216145833333333,0.9152777777777777,0.009895833333333333,0.017592592592592594
/home/dexter/Desktop/blackbuck/LEK_ANNOTATION/still_images/frame388.jpg,1213,939,1235,958,1224.0,948.5,1080,1920,19,22,0,0.6375,0.8782407407407408,0.011458333333333333,0.017592592592592594
/home/dexter/Desktop/blackbuck/LEK_ANNOTATION/still_images/frame388.jpg,1259,895,1279,916,1269.0,905.5,1080,1920,21,20,0,0.6609375,0.8384259259259259,0.010416666666666666,0.019444444444444445
/home/dexter/Desktop/blackbuck/LEK_ANNOTATION/still_images/frame388.jpg,1309,899,1335,917,1322.0,908.0,1080,1920,18,26,0,0.6885416666666667,0.8407407407407408,0.013541666666666667,0.016666666666666666
/home/dexter/Desktop/blackbuck/LEK_ANNOTATION/still_images/frame388.jpg,1292,851,1308,873,1300.0,862.0,1080,1920,22,16,0,0.6770833333333334,0.7981481481481482,0.008333333333333333,0.020370370370370372
/home/dexter/Desktop/blackbuck/LEK_ANNOTATION/still_images/frame388.jpg,1324,852,1349,873,1336.5,862.5,1080,1920,21,25,0,0.69609375,0.7986111111111112,0.013020833333333334,0.019444444444444445
/home/dexter/Desktop/blackbuck/LEK_ANNOTATION/still_images/frame388.jpg,1318,816,1341,832,1329.5,824.0,1080,1920,16,23,0,0.6924479166666667,0.762962962962963,0.011979166666666667,0.014814814814814815
/home/dexter/Desktop/blackbuck/LEK_ANNOTATION/still_images/frame388.jpg,1416,720,1440,735,1428.0,727.5,1080,1920,15,24,0,0.74375,0.6736111111111112,0.0125,0.013888888888888888
/home/dexter/Desktop/blackbuck/LEK_ANNOTATION/still_images/frame388.jpg,1444,698,1467,713,1455.5,705.5,1080,1920,15,23,0,0.7580729166666667,0.6532407407407408,0.011979166666666667,0.013888888888888888
/home/dexter/Desktop/blackbuck/LEK_ANNOTATION/still_images/frame388.jpg,1470,679,1496,697,1483.0,688.0,1080,1920,18,26,0,0.7723958333333333,0.6370370370370371,0.013541666666666667,0.016666666666666666
/home/dexter/Desktop/blackbuck/LEK_ANNOTATION/still_images/frame388.jpg,1511,626,1534,644,1522.5,635.0,1080,1920,18,23,0,0.79296875,0.5879629629629629,0.011979166666666667,0.016666666666666666
/home/dexter/Desktop/blackbuck/LEK_ANNOTATION/still_images/frame388.jpg,1623,555,1647,576,1635.0,565.5,1080,1920,21,24,0,0.8515625,0.5236111111111111,0.0125,0.019444444444444445
/home/dexter/Desktop/blackbuck/LEK_ANNOTATION/still_images/frame388.jpg,1708,504,1736,520,1722.0,512.0,1080,1920,16,28,0,0.896875,0.4740740740740741,0.014583333333333334,0.014814814814814815
/home/dexter/Desktop/blackbuck/LEK_ANNOTATION/still_images/frame388.jpg,1855,269,1876,288,1865.5,278.5,1080,1920,19,21,0,0.9716145833333333,0.25787037037037036,0.0109375,0.017592592592592594
/home/dexter/Desktop/blackbuck/LEK_ANNOTATION/still_images/frame388.jpg,1897,238,1918,252,1907.5,245.0,1080,1920,14,21,0,0.9934895833333334,0.22685185185185186,0.0109375,0.012962962962962963
/home/dexter/Desktop/blackbuck/LEK_ANNOTATION/still_images/frame622.jpg,629,564,646,581,637.5,572.5,1080,1920,17,17,0,0.33203125,0.5300925925925926,0.008854166666666666,0.01574074074074074
/home/dexter/Desktop/blackbuck/LEK_ANNOTATION/still_images/frame622.jpg,676,524,701,542,688.5,533.0,1080,1920,18,25,0,0.35859375,0.4935185185185185,0.013020833333333334,0.016666666666666666
/home/dexter/Desktop/blackbuck/LEK_ANNOTATION/still_images/frame622.jpg,731,529,751,547,741.0,538.0,1080,1920,18,20,0,0.3859375,0.4981481481481482,0.010416666666666666,0.016666666666666666
/home/dexter/Desktop/blackbuck/LEK_ANNOTATION/still_images/frame622.jpg,834,469,859,484,846.5,476.5,1080,1920,15,25,0,0.44088541666666664,0.4412037037037037,0.013020833333333334,0.013888888888888888
/home/dexter/Desktop/blackbuck/LEK_ANNOTATION/still_images/frame622.jpg,858,357,884,376,871.0,366.5,1080,1920,19,26,0,0.45364583333333336,0.33935185185185185,0.013541666666666667,0.017592592592592594
/home/dexter/Desktop/blackbuck/LEK_ANNOTATION/still_images/frame622.jpg,899,391,924,408,911.5,399.5,1080,1920,17,25,0,0.4747395833333333,0.3699074074074074,0.013020833333333334,0.01574074074074074
/home/dexter/Desktop/blackbuck/LEK_ANNOTATION/still_images/frame622.jpg,917,311,939,331,928.0,321.0,1080,1920,20,22,0,0.48333333333333334,0.2972222222222222,0.011458333333333333,0.018518518518518517
/home/dexter/Desktop/blackbuck/LEK_ANNOTATION/still_images/frame622.jpg,1026,254,1050,276,1038.0,265.0,1080,1920,22,24,0,0.540625,0.24537037037037038,0.0125,0.020370370370370372
/home/dexter/Desktop/blackbuck/LEK_ANNOTATION/still_images/frame622.jpg,1111,244,1139,258,1125.0,251.0,1080,1920,14,28,0,0.5859375,0.2324074074074074,0.014583333333333334,0.012962962962962963
/home/dexter/Desktop/blackbuck/LEK_ANNOTATION/still_images/frame622.jpg,680,982,708,994,694.0,988.0,1080,1920,12,28,0,0.3614583333333333,0.9148148148148149,0.014583333333333334,0.011111111111111112
/home/dexter/Desktop/blackbuck/LEK_ANNOTATION/still_images/frame622.jpg,865,964,880,992,872.5,978.0,1080,1920,28,15,0,0.4544270833333333,0.9055555555555556,0.0078125,0.025925925925925925
/home/dexter/Desktop/blackbuck/LEK_ANNOTATION/still_images/frame622.jpg,1048,665,1065,683,1056.5,674.0,1080,1920,18,17,0,0.5502604166666667,0.6240740740740741,0.008854166666666666,0.016666666666666666
/home/dexter/Desktop/blackbuck/LEK_ANNOTATION/still_images/frame622.jpg,1112,1064,1133,1078,1122.5,1071.0,1080,1920,14,21,0,0.5846354166666666,0.9916666666666667,0.0109375,0.012962962962962963
/home/dexter/Desktop/blackbuck/LEK_ANNOTATION/still_images/frame622.jpg,1132,1046,1149,1063,1140.5,1054.5,1080,1920,17,17,0,0.5940104166666667,0.9763888888888889,0.008854166666666666,0.01574074074074074
/home/dexter/Desktop/blackbuck/LEK_ANNOTATION/still_images/frame622.jpg,1148,1032,1165,1051,1156.5,1041.5,1080,1920,19,17,0,0.60234375,0.9643518518518519,0.008854166666666666,0.017592592592592594
/home/dexter/Desktop/blackbuck/LEK_ANNOTATION/still_images/frame622.jpg,1158,1012,1184,1033,1171.0,1022.5,1080,1920,21,26,0,0.6098958333333333,0.9467592592592593,0.013541666666666667,0.019444444444444445
/home/dexter/Desktop/blackbuck/LEK_ANNOTATION/still_images/frame622.jpg,1191,984,1213,1002,1202.0,993.0,1080,1920,18,22,0,0.6260416666666667,0.9194444444444444,0.011458333333333333,0.016666666666666666
/home/dexter/Desktop/blackbuck/LEK_ANNOTATION/still_images/frame622.jpg,1247,970,1270,994,1258.5,982.0,1080,1920,24,23,0,0.65546875,0.9092592592592592,0.011979166666666667,0.022222222222222223
/home/dexter/Desktop/blackbuck/LEK_ANNOTATION/still_images/frame622.jpg,1216,945,1236,963,1226.0,954.0,1080,1920,18,20,0,0.6385416666666667,0.8833333333333333,0.010416666666666666,0.016666666666666666
/home/dexter/Desktop/blackbuck/LEK_ANNOTATION/still_images/frame622.jpg,1237,927,1252,943,1244.5,935.0,1080,1920,16,15,0,0.6481770833333333,0.8657407407407407,0.0078125,0.014814814814814815
/home/dexter/Desktop/blackbuck/LEK_ANNOTATION/still_images/frame622.jpg,1265,891,1289,914,1277.0,902.5,1080,1920,23,24,0,0.6651041666666667,0.8356481481481481,0.0125,0.021296296296296296
/home/dexter/Desktop/blackbuck/LEK_ANNOTATION/still_images/frame622.jpg,1308,834,1328,865,1318.0,849.5,1080,1920,31,20,0,0.6864583333333333,0.7865740740740741,0.010416666666666666,0.028703703703703703
/home/dexter/Desktop/blackbuck/LEK_ANNOTATION/still_images/frame622.jpg,1366,845,1383,875,1374.5,860.0,1080,1920,30,17,0,0.7158854166666667,0.7962962962962963,0.008854166666666666,0.027777777777777776
/home/dexter/Desktop/blackbuck/LEK_ANNOTATION/still_images/frame622.jpg,1333,802,1356,820,1344.5,811.0,1080,1920,18,23,0,0.7002604166666667,0.7509259259259259,0.011979166666666667,0.016666666666666666
/home/dexter/Desktop/blackbuck/LEK_ANNOTATION/still_images/frame622.jpg,1379,809,1399,830,1389.0,819.5,1080,1920,21,20,0,0.7234375,0.7587962962962963,0.010416666666666666,0.019444444444444445
/home/dexter/Desktop/blackbuck/LEK_ANNOTATION/still_images/frame622.jpg,1362,773,1386,795,1374.0,784.0,1080,1920,22,24,0,0.715625,0.725925925925926,0.0125,0.020370370370370372
/home/dexter/Desktop/blackbuck/LEK_ANNOTATION/still_images/frame622.jpg,1483,674,1506,697,1494.5,685.5,1080,1920,23,23,0,0.7783854166666667,0.6347222222222222,0.011979166666666667,0.021296296296296296
/home/dexter/Desktop/blackbuck/LEK_ANNOTATION/still_images/frame622.jpg,1505,647,1523,670,1514.0,658.5,1080,1920,23,18,0,0.7885416666666667,0.6097222222222223,0.009375,0.021296296296296296
/home/dexter/Desktop/blackbuck/LEK_ANNOTATION/still_images/frame622.jpg,1520,620,1542,645,1531.0,632.5,1080,1920,25,22,0,0.7973958333333333,0.5856481481481481,0.011458333333333333,0.023148148148148147
/home/dexter/Desktop/blackbuck/LEK_ANNOTATION/still_images/frame622.jpg,1571,593,1600,612,1585.5,602.5,1080,1920,19,29,0,0.82578125,0.5578703703703703,0.015104166666666667,0.017592592592592594
/home/dexter/Desktop/blackbuck/LEK_ANNOTATION/still_images/frame622.jpg,1681,516,1706,535,1693.5,525.5,1080,1920,19,25,0,0.88203125,0.48657407407407405,0.013020833333333334,0.017592592592592594
/home/dexter/Desktop/blackbuck/LEK_ANNOTATION/still_images/frame622.jpg,1762,484,1787,502,1774.5,493.0,1080,1920,18,25,0,0.92421875,0.4564814814814815,0.013020833333333334,0.016666666666666666
/home/dexter/Desktop/blackbuck/LEK_ANNOTATION/still_images/frame622.jpg,1813,469,1840,486,1826.5,477.5,1080,1920,17,27,0,0.9513020833333333,0.44212962962962965,0.0140625,0.01574074074074074
/home/dexter/Desktop/blackbuck/LEK_ANNOTATION/still_images/frame292.jpg,567,635,582,651,574.5,643.0,1080,1920,16,15,0,0.29921875,0.5953703703703703,0.0078125,0.014814814814814815
/home/dexter/Desktop/blackbuck/LEK_ANNOTATION/still_images/frame292.jpg,604,586,619,610,611.5,598.0,1080,1920,24,15,0,0.3184895833333333,0.5537037037037037,0.0078125,0.022222222222222223
/home/dexter/Desktop/blackbuck/LEK_ANNOTATION/still_images/frame292.jpg,639,556,664,572,651.5,564.0,1080,1920,16,25,0,0.33932291666666664,0.5222222222222223,0.013020833333333334,0.014814814814814815
/home/dexter/Desktop/blackbuck/LEK_ANNOTATION/still_images/frame292.jpg,779,524,796,544,787.5,534.0,1080,1920,20,17,0,0.41015625,0.49444444444444446,0.008854166666666666,0.018518518518518517
/home/dexter/Desktop/blackbuck/LEK_ANNOTATION/still_images/frame292.jpg,779,424,800,454,789.5,439.0,1080,1920,30,21,0,0.41119791666666666,0.4064814814814815,0.0109375,0.027777777777777776
/home/dexter/Desktop/blackbuck/LEK_ANNOTATION/still_images/frame292.jpg,832,430,851,443,841.5,436.5,1080,1920,13,19,0,0.43828125,0.4041666666666667,0.009895833333333333,0.012037037037037037
/home/dexter/Desktop/blackbuck/LEK_ANNOTATION/still_images/frame292.jpg,835,378,858,396,846.5,387.0,1080,1920,18,23,0,0.44088541666666664,0.35833333333333334,0.011979166666666667,0.016666666666666666
/home/dexter/Desktop/blackbuck/LEK_ANNOTATION/still_images/frame292.jpg,934,298,957,318,945.5,308.0,1080,1920,20,23,0,0.49244791666666665,0.2851851851851852,0.011979166666666667,0.018518518518518517
/home/dexter/Desktop/blackbuck/LEK_ANNOTATION/still_images/frame292.jpg,1016,265,1042,280,1029.0,272.5,1080,1920,15,26,0,0.5359375,0.2523148148148148,0.013541666666666667,0.013888888888888888
/home/dexter/Desktop/blackbuck/LEK_ANNOTATION/still_images/frame292.jpg,964,720,992,738,978.0,729.0,1080,1920,18,28,0,0.509375,0.675,0.014583333333333334,0.016666666666666666
/home/dexter/Desktop/blackbuck/LEK_ANNOTATION/still_images/frame292.jpg,612,1018,630,1039,621.0,1028.5,1080,1920,21,18,0,0.3234375,0.9523148148148148,0.009375,0.019444444444444445
/home/dexter/Desktop/blackbuck/LEK_ANNOTATION/still_images/frame292.jpg,856,971,870,1001,863.0,986.0,1080,1920,30,14,0,0.44947916666666665,0.912962962962963,0.007291666666666667,0.027777777777777776
/home/dexter/Desktop/blackbuck/LEK_ANNOTATION/still_images/frame292.jpg,1140,1028,1162,1049,1151.0,1038.5,1080,1920,21,22,0,0.5994791666666667,0.961574074074074,0.011458333333333333,0.019444444444444445
/home/dexter/Desktop/blackbuck/LEK_ANNOTATION/still_images/frame292.jpg,1167,1004,1183,1023,1175.0,1013.5,1080,1920,19,16,0,0.6119791666666666,0.9384259259259259,0.008333333333333333,0.017592592592592594
/home/dexter/Desktop/blackbuck/LEK_ANNOTATION/still_images/frame292.jpg,1195,963,1215,987,1205.0,975.0,1080,1920,24,20,0,0.6276041666666666,0.9027777777777778,0.010416666666666666,0.022222222222222223
/home/dexter/Desktop/blackbuck/LEK_ANNOTATION/still_images/frame292.jpg,1236,915,1255,936,1245.5,925.5,1080,1920,21,19,0,0.6486979166666667,0.8569444444444444,0.009895833333333333,0.019444444444444445
/home/dexter/Desktop/blackbuck/LEK_ANNOTATION/still_images/frame292.jpg,1273,879,1294,896,1283.5,887.5,1080,1920,17,21,0,0.6684895833333333,0.8217592592592593,0.0109375,0.01574074074074074
/home/dexter/Desktop/blackbuck/LEK_ANNOTATION/still_images/frame292.jpg,1285,922,1313,934,1299.0,928.0,1080,1920,12,28,0,0.6765625,0.8592592592592593,0.014583333333333334,0.011111111111111112
/home/dexter/Desktop/blackbuck/LEK_ANNOTATION/still_images/frame292.jpg,1203,1031,1224,1046,1213.5,1038.5,1080,1920,15,21,0,0.63203125,0.961574074074074,0.0109375,0.013888888888888888
/home/dexter/Desktop/blackbuck/LEK_ANNOTATION/still_images/frame292.jpg,1303,871,1329,890,1316.0,880.5,1080,1920,19,26,0,0.6854166666666667,0.8152777777777778,0.013541666666666667,0.017592592592592594
/home/dexter/Desktop/blackbuck/LEK_ANNOTATION/still_images/frame292.jpg,1299,833,1321,858,1310.0,845.5,1080,1920,25,22,0,0.6822916666666666,0.7828703703703703,0.011458333333333333,0.023148148148148147
/home/dexter/Desktop/blackbuck/LEK_ANNOTATION/still_images/frame292.jpg,1393,736,1418,759,1405.5,747.5,1080,1920,23,25,0,0.73203125,0.6921296296296297,0.013020833333333334,0.021296296296296296
/home/dexter/Desktop/blackbuck/LEK_ANNOTATION/still_images/frame292.jpg,1418,719,1440,732,1429.0,725.5,1080,1920,13,22,0,0.7442708333333333,0.6717592592592593,0.011458333333333333,0.012037037037037037
/home/dexter/Desktop/blackbuck/LEK_ANNOTATION/still_images/frame292.jpg,1490,648,1516,672,1503.0,660.0,1080,1920,24,26,0,0.7828125,0.6111111111111112,0.013541666666666667,0.022222222222222223
/home/dexter/Desktop/blackbuck/LEK_ANNOTATION/still_images/frame292.jpg,1598,573,1626,593,1612.0,583.0,1080,1920,20,28,0,0.8395833333333333,0.5398148148148149,0.014583333333333334,0.018518518518518517
/home/dexter/Desktop/blackbuck/LEK_ANNOTATION/still_images/frame292.jpg,1687,516,1717,536,1702.0,526.0,1080,1920,20,30,0,0.8864583333333333,0.48703703703703705,0.015625,0.018518518518518517
/home/dexter/Desktop/blackbuck/LEK_ANNOTATION/still_images/frame292.jpg,1840,290,1860,310,1850.0,300.0,1080,1920,20,20,0,0.9635416666666666,0.2777777777777778,0.010416666666666666,0.018518518518518517
/home/dexter/Desktop/blackbuck/LEK_ANNOTATION/still_images/frame292.jpg,1877,252,1900,269,1888.5,260.5,1080,1920,17,23,0,0.98359375,0.2412037037037037,0.011979166666666667,0.01574074074074074
/home/dexter/Desktop/blackbuck/LEK_ANNOTATION/still_images/frame292.jpg,1874,361,1905,375,1889.5,368.0,1080,1920,14,31,0,0.9841145833333333,0.34074074074074073,0.016145833333333335,0.012962962962962963
/home/dexter/Desktop/blackbuck/LEK_ANNOTATION/still_images/frame204.jpg,551,651,564,669,557.5,660.0,1080,1920,18,13,0,0.2903645833333333,0.6111111111111112,0.0067708333333333336,0.016666666666666666
/home/dexter/Desktop/blackbuck/LEK_ANNOTATION/still_images/frame204.jpg,587,606,605,628,596.0,617.0,1080,1920,22,18,0,0.3104166666666667,0.5712962962962963,0.009375,0.020370370370370372
/home/dexter/Desktop/blackbuck/LEK_ANNOTATION/still_images/frame204.jpg,620,570,641,587,630.5,578.5,1080,1920,17,21,0,0.32838541666666665,0.5356481481481481,0.0109375,0.01574074074074074
/home/dexter/Desktop/blackbuck/LEK_ANNOTATION/still_images/frame204.jpg,758,541,783,556,770.5,548.5,1080,1920,15,25,0,0.40130208333333334,0.5078703703703704,0.013020833333333334,0.013888888888888888
/home/dexter/Desktop/blackbuck/LEK_ANNOTATION/still_images/frame204.jpg,765,449,783,468,774.0,458.5,1080,1920,19,18,0,0.403125,0.42453703703703705,0.009375,0.017592592592592594
/home/dexter/Desktop/blackbuck/LEK_ANNOTATION/still_images/frame204.jpg,806,442,828,453,817.0,447.5,1080,1920,11,22,0,0.42552083333333335,0.41435185185185186,0.011458333333333333,0.010185185185185186
/home/dexter/Desktop/blackbuck/LEK_ANNOTATION/still_images/frame204.jpg,822,392,841,411,831.5,401.5,1080,1920,19,19,0,0.43307291666666664,0.37175925925925923,0.009895833333333333,0.017592592592592594
/home/dexter/Desktop/blackbuck/LEK_ANNOTATION/still_images/frame204.jpg,920,309,941,335,930.5,322.0,1080,1920,26,21,0,0.48463541666666665,0.29814814814814816,0.0109375,0.024074074074074074
/home/dexter/Desktop/blackbuck/LEK_ANNOTATION/still_images/frame204.jpg,609,1017,629,1037,619.0,1027.0,1080,1920,20,20,0,0.3223958333333333,0.950925925925926,0.010416666666666666,0.018518518518518517
/home/dexter/Desktop/blackbuck/LEK_ANNOTATION/still_images/frame204.jpg,855,967,870,996,862.5,981.5,1080,1920,29,15,0,0.44921875,0.9087962962962963,0.0078125,0.026851851851851852
/home/dexter/Desktop/blackbuck/LEK_ANNOTATION/still_images/frame204.jpg,943,727,964,748,953.5,737.5,1080,1920,21,21,0,0.49661458333333336,0.6828703703703703,0.0109375,0.019444444444444445
/home/dexter/Desktop/blackbuck/LEK_ANNOTATION/still_images/frame204.jpg,1126,1049,1142,1074,1134.0,1061.5,1080,1920,25,16,0,0.590625,0.9828703703703704,0.008333333333333333,0.023148148148148147
/home/dexter/Desktop/blackbuck/LEK_ANNOTATION/still_images/frame204.jpg,1146,1021,1166,1040,1156.0,1030.5,1080,1920,19,20,0,0.6020833333333333,0.9541666666666667,0.010416666666666666,0.017592592592592594
/home/dexter/Desktop/blackbuck/LEK_ANNOTATION/still_images/frame204.jpg,1179,984,1198,1008,1188.5,996.0,1080,1920,24,19,0,0.6190104166666667,0.9222222222222223,0.009895833333333333,0.022222222222222223
/home/dexter/Desktop/blackbuck/LEK_ANNOTATION/still_images/frame204.jpg,1198,1035,1209,1060,1203.5,1047.5,1080,1920,25,11,0,0.6268229166666667,0.9699074074074074,0.005729166666666666,0.023148148148148147
/home/dexter/Desktop/blackbuck/LEK_ANNOTATION/still_images/frame204.jpg,1214,933,1240,959,1227.0,946.0,1080,1920,26,26,0,0.6390625,0.8759259259259259,0.013541666666666667,0.024074074074074074
/home/dexter/Desktop/blackbuck/LEK_ANNOTATION/still_images/frame204.jpg,1266,930,1289,950,1277.5,940.0,1080,1920,20,23,0,0.6653645833333334,0.8703703703703703,0.011979166666666667,0.018518518518518517
/home/dexter/Desktop/blackbuck/LEK_ANNOTATION/still_images/frame204.jpg,1257,889,1275,911,1266.0,900.0,1080,1920,22,18,0,0.659375,0.8333333333333334,0.009375,0.020370370370370372
/home/dexter/Desktop/blackbuck/LEK_ANNOTATION/still_images/frame204.jpg,1286,886,1310,907,1298.0,896.5,1080,1920,21,24,0,0.6760416666666667,0.8300925925925926,0.0125,0.019444444444444445
/home/dexter/Desktop/blackbuck/LEK_ANNOTATION/still_images/frame204.jpg,1290,845,1306,878,1298.0,861.5,1080,1920,33,16,0,0.6760416666666667,0.7976851851851852,0.008333333333333333,0.030555555555555555
/home/dexter/Desktop/blackbuck/LEK_ANNOTATION/still_images/frame204.jpg,1370,757,1398,779,1384.0,768.0,1080,1920,22,28,0,0.7208333333333333,0.7111111111111111,0.014583333333333334,0.020370370370370372
/home/dexter/Desktop/blackbuck/LEK_ANNOTATION/still_images/frame204.jpg,1400,739,1420,755,1410.0,747.0,1080,1920,16,20,0,0.734375,0.6916666666666667,0.010416666666666666,0.014814814814814815
/home/dexter/Desktop/blackbuck/LEK_ANNOTATION/still_images/frame204.jpg,1482,669,1504,693,1493.0,681.0,1080,1920,24,22,0,0.7776041666666667,0.6305555555555555,0.011458333333333333,0.022222222222222223
/home/dexter/Desktop/blackbuck/LEK_ANNOTATION/still_images/frame204.jpg,1582,584,1604,601,1593.0,592.5,1080,1920,17,22,0,0.8296875,0.5486111111111112,0.011458333333333333,0.01574074074074074
/home/dexter/Desktop/blackbuck/LEK_ANNOTATION/still_images/frame204.jpg,1665,528,1695,546,1680.0,537.0,1080,1920,18,30,0,0.875,0.49722222222222223,0.015625,0.016666666666666666
/home/dexter/Desktop/blackbuck/LEK_ANNOTATION/still_images/frame204.jpg,1849,371,1881,392,1865.0,381.5,1080,1920,21,32,0,0.9713541666666666,0.35324074074074074,0.016666666666666666,0.019444444444444445
/home/dexter/Desktop/blackbuck/LEK_ANNOTATION/still_images/frame204.jpg,1821,307,1843,332,1832.0,319.5,1080,1920,25,22,0,0.9541666666666667,0.29583333333333334,0.011458333333333333,0.023148148148148147
/home/dexter/Desktop/blackbuck/LEK_ANNOTATION/still_images/frame204.jpg,1848,270,1879,287,1863.5,278.5,1080,1920,17,31,0,0.9705729166666667,0.25787037037037036,0.016145833333333335,0.01574074074074074
/home/dexter/Desktop/blackbuck/LEK_ANNOTATION/still_images/frame398.jpg,585,611,605,629,595.0,620.0,1080,1920,18,20,0,0.3098958333333333,0.5740740740740741,0.010416666666666666,0.016666666666666666
/home/dexter/Desktop/blackbuck/LEK_ANNOTATION/still_images/frame398.jpg,627,564,646,584,636.5,574.0,1080,1920,20,19,0,0.33151041666666664,0.5314814814814814,0.009895833333333333,0.018518518518518517
/home/dexter/Desktop/blackbuck/LEK_ANNOTATION/still_images/frame398.jpg,670,551,691,563,680.5,557.0,1080,1920,12,21,0,0.35442708333333334,0.5157407407407407,0.0109375,0.011111111111111112
/home/dexter/Desktop/blackbuck/LEK_ANNOTATION/still_images/frame398.jpg,796,504,813,526,804.5,515.0,1080,1920,22,17,0,0.41901041666666666,0.47685185185185186,0.008854166666666666,0.020370370370370372
/home/dexter/Desktop/blackbuck/LEK_ANNOTATION/still_images/frame398.jpg,807,402,823,425,815.0,413.5,1080,1920,23,16,0,0.4244791666666667,0.38287037037037036,0.008333333333333333,0.021296296296296296
/home/dexter/Desktop/blackbuck/LEK_ANNOTATION/still_images/frame398.jpg,859,416,882,432,870.5,424.0,1080,1920,16,23,0,0.45338541666666665,0.3925925925925926,0.011979166666666667,0.014814814814814815
/home/dexter/Desktop/blackbuck/LEK_ANNOTATION/still_images/frame398.jpg,865,358,882,374,873.5,366.0,1080,1920,16,17,0,0.4549479166666667,0.3388888888888889,0.008854166666666666,0.014814814814814815
/home/dexter/Desktop/blackbuck/LEK_ANNOTATION/still_images/frame398.jpg,964,286,985,304,974.5,295.0,1080,1920,18,21,0,0.5075520833333333,0.27314814814814814,0.0109375,0.016666666666666666
/home/dexter/Desktop/blackbuck/LEK_ANNOTATION/still_images/frame398.jpg,1045,253,1071,268,1058.0,260.5,1080,1920,15,26,0,0.5510416666666667,0.2412037037037037,0.013541666666666667,0.013888888888888888
/home/dexter/Desktop/blackbuck/LEK_ANNOTATION/still_images/frame398.jpg,622,1006,641,1025,631.5,1015.5,1080,1920,19,19,0,0.32890625,0.9402777777777778,0.009895833333333333,0.017592592592592594
/home/dexter/Desktop/blackbuck/LEK_ANNOTATION/still_images/frame398.jpg,990,709,1016,723,1003.0,716.0,1080,1920,14,26,0,0.5223958333333333,0.662962962962963,0.013541666666666667,0.012962962962962963
/home/dexter/Desktop/blackbuck/LEK_ANNOTATION/still_images/frame398.jpg,857,970,874,1000,865.5,985.0,1080,1920,30,17,0,0.45078125,0.9120370370370371,0.008854166666666666,0.027777777777777776
/home/dexter/Desktop/blackbuck/LEK_ANNOTATION/still_images/frame398.jpg,1109,1058,1132,1078,1120.5,1068.0,1080,1920,20,23,0,0.58359375,0.9888888888888889,0.011979166666666667,0.018518518518518517
/home/dexter/Desktop/blackbuck/LEK_ANNOTATION/still_images/frame398.jpg,1142,1036,1156,1058,1149.0,1047.0,1080,1920,22,14,0,0.5984375,0.9694444444444444,0.007291666666666667,0.020370370370370372
/home/dexter/Desktop/blackbuck/LEK_ANNOTATION/still_images/frame398.jpg,1167,1001,1188,1022,1177.5,1011.5,1080,1920,21,21,0,0.61328125,0.9365740740740741,0.0109375,0.019444444444444445
/home/dexter/Desktop/blackbuck/LEK_ANNOTATION/still_images/frame398.jpg,1208,1014,1225,1033,1216.5,1023.5,1080,1920,19,17,0,0.63359375,0.9476851851851852,0.008854166666666666,0.017592592592592594
/home/dexter/Desktop/blackbuck/LEK_ANNOTATION/still_images/frame398.jpg,1189,979,1207,995,1198.0,987.0,1080,1920,16,18,0,0.6239583333333333,0.9138888888888889,0.009375,0.014814814814814815
/home/dexter/Desktop/blackbuck/LEK_ANNOTATION/still_images/frame398.jpg,1218,933,1237,957,1227.5,945.0,1080,1920,24,19,0,0.6393229166666666,0.875,0.009895833333333333,0.022222222222222223
/home/dexter/Desktop/blackbuck/LEK_ANNOTATION/still_images/frame398.jpg,1312,891,1336,918,1324.0,904.5,1080,1920,27,24,0,0.6895833333333333,0.8375,0.0125,0.025
/home/dexter/Desktop/blackbuck/LEK_ANNOTATION/still_images/frame398.jpg,1260,893,1285,912,1272.5,902.5,1080,1920,19,25,0,0.6627604166666666,0.8356481481481481,0.013020833333333334,0.017592592592592594
/home/dexter/Desktop/blackbuck/LEK_ANNOTATION/still_images/frame398.jpg,1289,848,1312,868,1300.5,858.0,1080,1920,20,23,0,0.67734375,0.7944444444444444,0.011979166666666667,0.018518518518518517
/home/dexter/Desktop/blackbuck/LEK_ANNOTATION/still_images/frame398.jpg,1318,809,1341,834,1329.5,821.5,1080,1920,25,23,0,0.6924479166666667,0.7606481481481482,0.011979166666666667,0.023148148148148147
/home/dexter/Desktop/blackbuck/LEK_ANNOTATION/still_images/frame398.jpg,1328,851,1350,867,1339.0,859.0,1080,1920,16,22,0,0.6973958333333333,0.7953703703703704,0.011458333333333333,0.014814814814814815
/home/dexter/Desktop/blackbuck/LEK_ANNOTATION/still_images/frame398.jpg,1418,713,1442,734,1430.0,723.5,1080,1920,21,24,0,0.7447916666666666,0.6699074074074074,0.0125,0.019444444444444445
/home/dexter/Desktop/blackbuck/LEK_ANNOTATION/still_images/frame398.jpg,1450,697,1470,707,1460.0,702.0,1080,1920,10,20,0,0.7604166666666666,0.65,0.010416666666666666,0.009259259259259259
/home/dexter/Desktop/blackbuck/LEK_ANNOTATION/still_images/frame398.jpg,1475,678,1498,694,1486.5,686.0,1080,1920,16,23,0,0.77421875,0.6351851851851852,0.011979166666666667,0.014814814814814815
/home/dexter/Desktop/blackbuck/LEK_ANNOTATION/still_images/frame398.jpg,1512,626,1538,642,1525.0,634.0,1080,1920,16,26,0,0.7942708333333334,0.587037037037037,0.013541666666666667,0.014814814814814815
/home/dexter/Desktop/blackbuck/LEK_ANNOTATION/still_images/frame398.jpg,1628,554,1648,572,1638.0,563.0,1080,1920,18,20,0,0.853125,0.5212962962962963,0.010416666666666666,0.016666666666666666
/home/dexter/Desktop/blackbuck/LEK_ANNOTATION/still_images/frame398.jpg,1712,503,1743,519,1727.5,511.0,1080,1920,16,31,0,0.8997395833333334,0.47314814814814815,0.016145833333333335,0.014814814814814815
/home/dexter/Desktop/blackbuck/LEK_ANNOTATION/still_images/frame398.jpg,1739,489,1768,504,1753.5,496.5,1080,1920,15,29,0,0.91328125,0.4597222222222222,0.015104166666666667,0.013888888888888888
/home/dexter/Desktop/blackbuck/LEK_ANNOTATION/still_images/frame398.jpg,1859,265,1878,290,1868.5,277.5,1080,1920,25,19,0,0.9731770833333333,0.2569444444444444,0.009895833333333333,0.023148148148148147
/home/dexter/Desktop/blackbuck/LEK_ANNOTATION/still_images/frame40.jpg,515,689,532,707,523.5,698.0,1080,1920,18,17,0,0.27265625,0.6462962962962963,0.008854166666666666,0.016666666666666666
/home/dexter/Desktop/blackbuck/LEK_ANNOTATION/still_images/frame40.jpg,552,646,573,662,562.5,654.0,1080,1920,16,21,0,0.29296875,0.6055555555555555,0.0109375,0.014814814814814815
/home/dexter/Desktop/blackbuck/LEK_ANNOTATION/still_images/frame40.jpg,584,607,608,622,596.0,614.5,1080,1920,15,24,0,0.3104166666666667,0.5689814814814815,0.0125,0.013888888888888888
/home/dexter/Desktop/blackbuck/LEK_ANNOTATION/still_images/frame40.jpg,729,565,743,585,736.0,575.0,1080,1920,20,14,0,0.38333333333333336,0.5324074074074074,0.007291666666666667,0.018518518518518517
/home/dexter/Desktop/blackbuck/LEK_ANNOTATION/still_images/frame40.jpg,720,482,743,505,731.5,493.5,1080,1920,23,23,0,0.3809895833333333,0.45694444444444443,0.011979166666666667,0.021296296296296296
/home/dexter/Desktop/blackbuck/LEK_ANNOTATION/still_images/frame40.jpg,754,459,775,475,764.5,467.0,1080,1920,16,21,0,0.39817708333333335,0.4324074074074074,0.0109375,0.014814814814814815
/home/dexter/Desktop/blackbuck/LEK_ANNOTATION/still_images/frame40.jpg,787,422,800,447,793.5,434.5,1080,1920,25,13,0,0.41328125,0.4023148148148148,0.0067708333333333336,0.023148148148148147
/home/dexter/Desktop/blackbuck/LEK_ANNOTATION/still_images/frame40.jpg,881,341,904,359,892.5,350.0,1080,1920,18,23,0,0.46484375,0.32407407407407407,0.011979166666666667,0.016666666666666666
/home/dexter/Desktop/blackbuck/LEK_ANNOTATION/still_images/frame40.jpg,950,275,972,288,961.0,281.5,1080,1920,13,22,0,0.5005208333333333,0.26064814814814813,0.011458333333333333,0.012037037037037037
/home/dexter/Desktop/blackbuck/LEK_ANNOTATION/still_images/frame40.jpg,610,1020,625,1038,617.5,1029.0,1080,1920,18,15,0,0.3216145833333333,0.9527777777777777,0.0078125,0.016666666666666666
/home/dexter/Desktop/blackbuck/LEK_ANNOTATION/still_images/frame40.jpg,848,974,865,1000,856.5,987.0,1080,1920,26,17,0,0.44609375,0.9138888888888889,0.008854166666666666,0.024074074074074074
/home/dexter/Desktop/blackbuck/LEK_ANNOTATION/still_images/frame40.jpg,898,757,920,770,909.0,763.5,1080,1920,13,22,0,0.4734375,0.7069444444444445,0.011458333333333333,0.012037037037037037
/home/dexter/Desktop/blackbuck/LEK_ANNOTATION/still_images/frame40.jpg,1114,1053,1132,1071,1123.0,1062.0,1080,1920,18,18,0,0.5848958333333333,0.9833333333333333,0.009375,0.016666666666666666
/home/dexter/Desktop/blackbuck/LEK_ANNOTATION/still_images/frame40.jpg,1142,1024,1162,1043,1152.0,1033.5,1080,1920,19,20,0,0.6,0.9569444444444445,0.010416666666666666,0.017592592592592594
/home/dexter/Desktop/blackbuck/LEK_ANNOTATION/still_images/frame40.jpg,1184,976,1215,992,1199.5,984.0,1080,1920,16,31,0,0.6247395833333333,0.9111111111111111,0.016145833333333335,0.014814814814814815
/home/dexter/Desktop/blackbuck/LEK_ANNOTATION/still_images/frame40.jpg,1234,962,1257,987,1245.5,974.5,1080,1920,25,23,0,0.6486979166666667,0.9023148148148148,0.011979166666666667,0.023148148148148147
/home/dexter/Desktop/blackbuck/LEK_ANNOTATION/still_images/frame40.jpg,1232,921,1251,936,1241.5,928.5,1080,1920,15,19,0,0.6466145833333333,0.8597222222222223,0.009895833333333333,0.013888888888888888
/home/dexter/Desktop/blackbuck/LEK_ANNOTATION/still_images/frame40.jpg,1260,909,1282,925,1271.0,917.0,1080,1920,16,22,0,0.6619791666666667,0.8490740740740741,0.011458333333333333,0.014814814814814815
/home/dexter/Desktop/blackbuck/LEK_ANNOTATION/still_images/frame40.jpg,1268,884,1290,902,1279.0,893.0,1080,1920,18,22,0,0.6661458333333333,0.8268518518518518,0.011458333333333333,0.016666666666666666
/home/dexter/Desktop/blackbuck/LEK_ANNOTATION/still_images/frame40.jpg,1340,791,1358,812,1349.0,801.5,1080,1920,21,18,0,0.7026041666666667,0.7421296296296296,0.009375,0.019444444444444445
/home/dexter/Desktop/blackbuck/LEK_ANNOTATION/still_images/frame40.jpg,1358,769,1380,784,1369.0,776.5,1080,1920,15,22,0,0.7130208333333333,0.7189814814814814,0.011458333333333333,0.013888888888888888
/home/dexter/Desktop/blackbuck/LEK_ANNOTATION/still_images/frame40.jpg,1389,743,1410,761,1399.5,752.0,1080,1920,18,21,0,0.72890625,0.6962962962962963,0.0109375,0.016666666666666666
/home/dexter/Desktop/blackbuck/LEK_ANNOTATION/still_images/frame40.jpg,1434,703,1464,718,1449.0,710.5,1080,1920,15,30,0,0.7546875,0.6578703703703703,0.015625,0.013888888888888888
/home/dexter/Desktop/blackbuck/LEK_ANNOTATION/still_images/frame40.jpg,1541,616,1563,636,1552.0,626.0,1080,1920,20,22,0,0.8083333333333333,0.5796296296296296,0.011458333333333333,0.018518518518518517
/home/dexter/Desktop/blackbuck/LEK_ANNOTATION/still_images/frame40.jpg,1629,551,1656,567,1642.5,559.0,1080,1920,16,27,0,0.85546875,0.5175925925925926,0.0140625,0.014814814814814815
/home/dexter/Desktop/blackbuck/LEK_ANNOTATION/still_images/frame40.jpg,1702,507,1729,526,1715.5,516.5,1080,1920,19,27,0,0.8934895833333333,0.47824074074074074,0.0140625,0.017592592592592594
/home/dexter/Desktop/blackbuck/LEK_ANNOTATION/still_images/frame40.jpg,1817,399,1843,413,1830.0,406.0,1080,1920,14,26,0,0.953125,0.37592592592592594,0.013541666666666667,0.012962962962962963
/home/dexter/Desktop/blackbuck/LEK_ANNOTATION/still_images/frame40.jpg,1779,342,1808,353,1793.5,347.5,1080,1920,11,29,0,0.9341145833333333,0.32175925925925924,0.015104166666666667,0.010185185185185186
/home/dexter/Desktop/blackbuck/LEK_ANNOTATION/still_images/frame40.jpg,1825,303,1847,323,1836.0,313.0,1080,1920,20,22,0,0.95625,0.2898148148148148,0.011458333333333333,0.018518518518518517
/home/dexter/Desktop/blackbuck/LEK_ANNOTATION/still_images/frame40.jpg,1876,266,1896,288,1886.0,277.0,1080,1920,22,20,0,0.9822916666666667,0.2564814814814815,0.010416666666666666,0.020370370370370372
/home/dexter/Desktop/blackbuck/LEK_ANNOTATION/still_images/frame414.jpg,550,654,568,668,559.0,661.0,1080,1920,14,18,0,0.2911458333333333,0.612037037037037,0.009375,0.012962962962962963
/home/dexter/Desktop/blackbuck/LEK_ANNOTATION/still_images/frame414.jpg,590,606,605,623,597.5,614.5,1080,1920,17,15,0,0.3111979166666667,0.5689814814814815,0.0078125,0.01574074074074074
/home/dexter/Desktop/blackbuck/LEK_ANNOTATION/still_images/frame414.jpg,627,563,647,577,637.0,570.0,1080,1920,14,20,0,0.33177083333333335,0.5277777777777778,0.010416666666666666,0.012962962962962963
/home/dexter/Desktop/blackbuck/LEK_ANNOTATION/still_images/frame414.jpg,673,550,700,559,686.5,554.5,1080,1920,9,27,0,0.3575520833333333,0.513425925925926,0.0140625,0.008333333333333333
/home/dexter/Desktop/blackbuck/LEK_ANNOTATION/still_images/frame414.jpg,799,503,817,524,808.0,513.5,1080,1920,21,18,0,0.42083333333333334,0.475462962962963,0.009375,0.019444444444444445
/home/dexter/Desktop/blackbuck/LEK_ANNOTATION/still_images/frame414.jpg,808,398,825,420,816.5,409.0,1080,1920,22,17,0,0.42526041666666664,0.3787037037037037,0.008854166666666666,0.020370370370370372
/home/dexter/Desktop/blackbuck/LEK_ANNOTATION/still_images/frame414.jpg,861,413,883,428,872.0,420.5,1080,1920,15,22,0,0.45416666666666666,0.38935185185185184,0.011458333333333333,0.013888888888888888
/home/dexter/Desktop/blackbuck/LEK_ANNOTATION/still_images/frame414.jpg,869,350,887,375,878.0,362.5,1080,1920,25,18,0,0.45729166666666665,0.33564814814814814,0.009375,0.023148148148148147
/home/dexter/Desktop/blackbuck/LEK_ANNOTATION/still_images/frame414.jpg,965,283,990,302,977.5,292.5,1080,1920,19,25,0,0.5091145833333334,0.2708333333333333,0.013020833333333334,0.017592592592592594
/home/dexter/Desktop/blackbuck/LEK_ANNOTATION/still_images/frame414.jpg,1052,253,1076,268,1064.0,260.5,1080,1920,15,24,0,0.5541666666666667,0.2412037037037037,0.0125,0.013888888888888888
/home/dexter/Desktop/blackbuck/LEK_ANNOTATION/still_images/frame414.jpg,627,999,644,1023,635.5,1011.0,1080,1920,24,17,0,0.33098958333333334,0.9361111111111111,0.008854166666666666,0.022222222222222223
/home/dexter/Desktop/blackbuck/LEK_ANNOTATION/still_images/frame414.jpg,859,966,876,996,867.5,981.0,1080,1920,30,17,0,0.4518229166666667,0.9083333333333333,0.008854166666666666,0.027777777777777776
/home/dexter/Desktop/blackbuck/LEK_ANNOTATION/still_images/frame414.jpg,997,703,1022,721,1009.5,712.0,1080,1920,18,25,0,0.52578125,0.6592592592592592,0.013020833333333334,0.016666666666666666
/home/dexter/Desktop/blackbuck/LEK_ANNOTATION/still_images/frame414.jpg,1113,1053,1137,1075,1125.0,1064.0,1080,1920,22,24,0,0.5859375,0.9851851851851852,0.0125,0.020370370370370372
/home/dexter/Desktop/blackbuck/LEK_ANNOTATION/still_images/frame414.jpg,1142,1026,1158,1055,1150.0,1040.5,1080,1920,29,16,0,0.5989583333333334,0.9634259259259259,0.008333333333333333,0.026851851851851852
/home/dexter/Desktop/blackbuck/LEK_ANNOTATION/still_images/frame414.jpg,1170,995,1192,1021,1181.0,1008.0,1080,1920,26,22,0,0.6151041666666667,0.9333333333333333,0.011458333333333333,0.024074074074074074
/home/dexter/Desktop/blackbuck/LEK_ANNOTATION/still_images/frame414.jpg,1209,1009,1231,1033,1220.0,1021.0,1080,1920,24,22,0,0.6354166666666666,0.9453703703703704,0.011458333333333333,0.022222222222222223
/home/dexter/Desktop/blackbuck/LEK_ANNOTATION/still_images/frame414.jpg,1192,977,1210,990,1201.0,983.5,1080,1920,13,18,0,0.6255208333333333,0.9106481481481481,0.009375,0.012037037037037037
/home/dexter/Desktop/blackbuck/LEK_ANNOTATION/still_images/frame414.jpg,1219,932,1242,956,1230.5,944.0,1080,1920,24,23,0,0.6408854166666667,0.8740740740740741,0.011979166666666667,0.022222222222222223
/home/dexter/Desktop/blackbuck/LEK_ANNOTATION/still_images/frame414.jpg,1264,887,1289,910,1276.5,898.5,1080,1920,23,25,0,0.66484375,0.8319444444444445,0.013020833333333334,0.021296296296296296
/home/dexter/Desktop/blackbuck/LEK_ANNOTATION/still_images/frame414.jpg,1314,890,1340,912,1327.0,901.0,1080,1920,22,26,0,0.6911458333333333,0.8342592592592593,0.013541666666666667,0.020370370370370372
/home/dexter/Desktop/blackbuck/LEK_ANNOTATION/still_images/frame414.jpg,1295,844,1314,864,1304.5,854.0,1080,1920,20,19,0,0.6794270833333333,0.7907407407407407,0.009895833333333333,0.018518518518518517
/home/dexter/Desktop/blackbuck/LEK_ANNOTATION/still_images/frame414.jpg,1330,849,1354,864,1342.0,856.5,1080,1920,15,24,0,0.6989583333333333,0.7930555555555555,0.0125,0.013888888888888888
/home/dexter/Desktop/blackbuck/LEK_ANNOTATION/still_images/frame414.jpg,1324,812,1343,830,1333.5,821.0,1080,1920,18,19,0,0.69453125,0.7601851851851852,0.009895833333333333,0.016666666666666666
/home/dexter/Desktop/blackbuck/LEK_ANNOTATION/still_images/frame414.jpg,1418,709,1448,729,1433.0,719.0,1080,1920,20,30,0,0.7463541666666667,0.6657407407407407,0.015625,0.018518518518518517
/home/dexter/Desktop/blackbuck/LEK_ANNOTATION/still_images/frame414.jpg,1453,693,1477,706,1465.0,699.5,1080,1920,13,24,0,0.7630208333333334,0.6476851851851851,0.0125,0.012037037037037037
/home/dexter/Desktop/blackbuck/LEK_ANNOTATION/still_images/frame414.jpg,1480,673,1503,693,1491.5,683.0,1080,1920,20,23,0,0.7768229166666667,0.6324074074074074,0.011979166666666667,0.018518518518518517
/home/dexter/Desktop/blackbuck/LEK_ANNOTATION/still_images/frame414.jpg,1514,621,1543,641,1528.5,631.0,1080,1920,20,29,0,0.79609375,0.5842592592592593,0.015104166666666667,0.018518518518518517
/home/dexter/Desktop/blackbuck/LEK_ANNOTATION/still_images/frame414.jpg,1628,552,1652,567,1640.0,559.5,1080,1920,15,24,0,0.8541666666666666,0.5180555555555556,0.0125,0.013888888888888888
/home/dexter/Desktop/blackbuck/LEK_ANNOTATION/still_images/frame414.jpg,1714,502,1744,516,1729.0,509.0,1080,1920,14,30,0,0.9005208333333333,0.47129629629629627,0.015625,0.012962962962962963
/home/dexter/Desktop/blackbuck/LEK_ANNOTATION/still_images/frame414.jpg,1746,490,1771,501,1758.5,495.5,1080,1920,11,25,0,0.9158854166666667,0.4587962962962963,0.013020833333333334,0.010185185185185186
/home/dexter/Desktop/blackbuck/LEK_ANNOTATION/still_images/frame414.jpg,1861,263,1882,283,1871.5,273.0,1080,1920,20,21,0,0.9747395833333333,0.25277777777777777,0.0109375,0.018518518518518517
/home/dexter/Desktop/blackbuck/LEK_ANNOTATION/still_images/frame408.jpg,589,607,608,628,598.5,617.5,1080,1920,21,19,0,0.31171875,0.5717592592592593,0.009895833333333333,0.019444444444444445
/home/dexter/Desktop/blackbuck/LEK_ANNOTATION/still_images/frame408.jpg,630,562,647,582,638.5,572.0,1080,1920,20,17,0,0.33255208333333336,0.5296296296296297,0.008854166666666666,0.018518518518518517
/home/dexter/Desktop/blackbuck/LEK_ANNOTATION/still_images/frame408.jpg,674,544,695,565,684.5,554.5,1080,1920,21,21,0,0.35651041666666666,0.513425925925926,0.0109375,0.019444444444444445
/home/dexter/Desktop/blackbuck/LEK_ANNOTATION/still_images/frame408.jpg,796,501,815,524,805.5,512.5,1080,1920,23,19,0,0.41953125,0.47453703703703703,0.009895833333333333,0.021296296296296296
/home/dexter/Desktop/blackbuck/LEK_ANNOTATION/still_images/frame408.jpg,807,398,826,423,816.5,410.5,1080,1920,25,19,0,0.42526041666666664,0.3800925925925926,0.009895833333333333,0.023148148148148147
/home/dexter/Desktop/blackbuck/LEK_ANNOTATION/still_images/frame408.jpg,860,412,884,430,872.0,421.0,1080,1920,18,24,0,0.45416666666666666,0.38981481481481484,0.0125,0.016666666666666666
/home/dexter/Desktop/blackbuck/LEK_ANNOTATION/still_images/frame408.jpg,865,354,887,371,876.0,362.5,1080,1920,17,22,0,0.45625,0.33564814814814814,0.011458333333333333,0.01574074074074074
/home/dexter/Desktop/blackbuck/LEK_ANNOTATION/still_images/frame408.jpg,964,288,990,303,977.0,295.5,1080,1920,15,26,0,0.5088541666666667,0.27361111111111114,0.013541666666666667,0.013888888888888888
/home/dexter/Desktop/blackbuck/LEK_ANNOTATION/still_images/frame408.jpg,1049,253,1071,268,1060.0,260.5,1080,1920,15,22,0,0.5520833333333334,0.2412037037037037,0.011458333333333333,0.013888888888888888
/home/dexter/Desktop/blackbuck/LEK_ANNOTATION/still_images/frame408.jpg,624,1002,643,1025,633.5,1013.5,1080,1920,23,19,0,0.3299479166666667,0.9384259259259259,0.009895833333333333,0.021296296296296296
/home/dexter/Desktop/blackbuck/LEK_ANNOTATION/still_images/frame408.jpg,857,966,873,996,865.0,981.0,1080,1920,30,16,0,0.4505208333333333,0.9083333333333333,0.008333333333333333,0.027777777777777776
/home/dexter/Desktop/blackbuck/LEK_ANNOTATION/still_images/frame408.jpg,993,705,1021,721,1007.0,713.0,1080,1920,16,28,0,0.5244791666666667,0.6601851851851852,0.014583333333333334,0.014814814814814815
/home/dexter/Desktop/blackbuck/LEK_ANNOTATION/still_images/frame408.jpg,1108,1053,1136,1078,1122.0,1065.5,1080,1920,25,28,0,0.584375,0.986574074074074,0.014583333333333334,0.023148148148148147
/home/dexter/Desktop/blackbuck/LEK_ANNOTATION/still_images/frame408.jpg,1140,1029,1159,1055,1149.5,1042.0,1080,1920,26,19,0,0.5986979166666667,0.9648148148148148,0.009895833333333333,0.024074074074074074
/home/dexter/Desktop/blackbuck/LEK_ANNOTATION/still_images/frame408.jpg,1167,996,1190,1022,1178.5,1009.0,1080,1920,26,23,0,0.6138020833333333,0.9342592592592592,0.011979166666666667,0.024074074074074074
/home/dexter/Desktop/blackbuck/LEK_ANNOTATION/still_images/frame408.jpg,1210,1008,1227,1035,1218.5,1021.5,1080,1920,27,17,0,0.6346354166666667,0.9458333333333333,0.008854166666666666,0.025
/home/dexter/Desktop/blackbuck/LEK_ANNOTATION/still_images/frame408.jpg,1190,972,1207,994,1198.5,983.0,1080,1920,22,17,0,0.62421875,0.9101851851851852,0.008854166666666666,0.020370370370370372
/home/dexter/Desktop/blackbuck/LEK_ANNOTATION/still_images/frame408.jpg,1220,933,1239,955,1229.5,944.0,1080,1920,22,19,0,0.6403645833333333,0.8740740740740741,0.009895833333333333,0.020370370370370372
/home/dexter/Desktop/blackbuck/LEK_ANNOTATION/still_images/frame408.jpg,1261,890,1289,911,1275.0,900.5,1080,1920,21,28,0,0.6640625,0.8337962962962963,0.014583333333333334,0.019444444444444445
/home/dexter/Desktop/blackbuck/LEK_ANNOTATION/still_images/frame408.jpg,1311,893,1340,915,1325.5,904.0,1080,1920,22,29,0,0.6903645833333333,0.837037037037037,0.015104166666666667,0.020370370370370372
/home/dexter/Desktop/blackbuck/LEK_ANNOTATION/still_images/frame408.jpg,1292,846,1315,869,1303.5,857.5,1080,1920,23,23,0,0.67890625,0.7939814814814815,0.011979166666666667,0.021296296296296296
/home/dexter/Desktop/blackbuck/LEK_ANNOTATION/still_images/frame408.jpg,1330,851,1352,868,1341.0,859.5,1080,1920,17,22,0,0.6984375,0.7958333333333333,0.011458333333333333,0.01574074074074074
/home/dexter/Desktop/blackbuck/LEK_ANNOTATION/still_images/frame408.jpg,1321,808,1344,831,1332.5,819.5,1080,1920,23,23,0,0.6940104166666666,0.7587962962962963,0.011979166666666667,0.021296296296296296
/home/dexter/Desktop/blackbuck/LEK_ANNOTATION/still_images/frame408.jpg,1420,713,1445,729,1432.5,721.0,1080,1920,16,25,0,0.74609375,0.6675925925925926,0.013020833333333334,0.014814814814814815
/home/dexter/Desktop/blackbuck/LEK_ANNOTATION/still_images/frame408.jpg,1452,692,1475,710,1463.5,701.0,1080,1920,18,23,0,0.7622395833333333,0.649074074074074,0.011979166666666667,0.016666666666666666
/home/dexter/Desktop/blackbuck/LEK_ANNOTATION/still_images/frame408.jpg,1476,673,1504,692,1490.0,682.5,1080,1920,19,28,0,0.7760416666666666,0.6319444444444444,0.014583333333333334,0.017592592592592594
/home/dexter/Desktop/blackbuck/LEK_ANNOTATION/still_images/frame408.jpg,1515,621,1539,640,1527.0,630.5,1080,1920,19,24,0,0.7953125,0.5837962962962963,0.0125,0.017592592592592594
/home/dexter/Desktop/blackbuck/LEK_ANNOTATION/still_images/frame408.jpg,1626,551,1651,569,1638.5,560.0,1080,1920,18,25,0,0.8533854166666667,0.5185185185185185,0.013020833333333334,0.016666666666666666
/home/dexter/Desktop/blackbuck/LEK_ANNOTATION/still_images/frame408.jpg,1713,504,1743,520,1728.0,512.0,1080,1920,16,30,0,0.9,0.4740740740740741,0.015625,0.014814814814814815
/home/dexter/Desktop/blackbuck/LEK_ANNOTATION/still_images/frame408.jpg,1742,486,1773,503,1757.5,494.5,1080,1920,17,31,0,0.9153645833333334,0.45787037037037037,0.016145833333333335,0.01574074074074074
/home/dexter/Desktop/blackbuck/LEK_ANNOTATION/still_images/frame408.jpg,1856,261,1881,284,1868.5,272.5,1080,1920,23,25,0,0.9731770833333333,0.2523148148148148,0.013020833333333334,0.021296296296296296
/home/dexter/Desktop/blackbuck/LEK_ANNOTATION/still_images/frame270.jpg,559,638,578,657,568.5,647.5,1080,1920,19,19,0,0.29609375,0.5995370370370371,0.009895833333333333,0.017592592592592594
/home/dexter/Desktop/blackbuck/LEK_ANNOTATION/still_images/frame270.jpg,597,594,617,616,607.0,605.0,1080,1920,22,20,0,0.31614583333333335,0.5601851851851852,0.010416666666666666,0.020370370370370372
/home/dexter/Desktop/blackbuck/LEK_ANNOTATION/still_images/frame270.jpg,635,562,657,578,646.0,570.0,1080,1920,16,22,0,0.33645833333333336,0.5277777777777778,0.011458333333333333,0.014814814814814815
/home/dexter/Desktop/blackbuck/LEK_ANNOTATION/still_images/frame270.jpg,776,530,793,549,784.5,539.5,1080,1920,19,17,0,0.40859375,0.49953703703703706,0.008854166666666666,0.017592592592592594
/home/dexter/Desktop/blackbuck/LEK_ANNOTATION/still_images/frame270.jpg,779,433,799,454,789.0,443.5,1080,1920,21,20,0,0.4109375,0.41064814814814815,0.010416666666666666,0.019444444444444445
/home/dexter/Desktop/blackbuck/LEK_ANNOTATION/still_images/frame270.jpg,824,432,845,450,834.5,441.0,1080,1920,18,21,0,0.43463541666666666,0.4083333333333333,0.0109375,0.016666666666666666
/home/dexter/Desktop/blackbuck/LEK_ANNOTATION/still_images/frame270.jpg,832,381,855,398,843.5,389.5,1080,1920,17,23,0,0.4393229166666667,0.36064814814814816,0.011979166666666667,0.01574074074074074
/home/dexter/Desktop/blackbuck/LEK_ANNOTATION/still_images/frame270.jpg,930,301,952,323,941.0,312.0,1080,1920,22,22,0,0.4901041666666667,0.28888888888888886,0.011458333333333333,0.020370370370370372
/home/dexter/Desktop/blackbuck/LEK_ANNOTATION/still_images/frame270.jpg,1007,269,1035,283,1021.0,276.0,1080,1920,14,28,0,0.5317708333333333,0.25555555555555554,0.014583333333333334,0.012962962962962963
/home/dexter/Desktop/blackbuck/LEK_ANNOTATION/still_images/frame270.jpg,956,721,984,741,970.0,731.0,1080,1920,20,28,0,0.5052083333333334,0.6768518518518518,0.014583333333333334,0.018518518518518517
/home/dexter/Desktop/blackbuck/LEK_ANNOTATION/still_images/frame270.jpg,612,1016,630,1040,621.0,1028.0,1080,1920,24,18,0,0.3234375,0.9518518518518518,0.009375,0.022222222222222223
/home/dexter/Desktop/blackbuck/LEK_ANNOTATION/still_images/frame270.jpg,853,969,871,999,862.0,984.0,1080,1920,30,18,0,0.44895833333333335,0.9111111111111111,0.009375,0.027777777777777776
/home/dexter/Desktop/blackbuck/LEK_ANNOTATION/still_images/frame270.jpg,1138,1033,1156,1056,1147.0,1044.5,1080,1920,23,18,0,0.5973958333333333,0.9671296296296297,0.009375,0.021296296296296296
/home/dexter/Desktop/blackbuck/LEK_ANNOTATION/still_images/frame270.jpg,1163,1007,1180,1030,1171.5,1018.5,1080,1920,23,17,0,0.61015625,0.9430555555555555,0.008854166666666666,0.021296296296296296
/home/dexter/Desktop/blackbuck/LEK_ANNOTATION/still_images/frame270.jpg,1190,972,1209,993,1199.5,982.5,1080,1920,21,19,0,0.6247395833333333,0.9097222222222222,0.009895833333333333,0.019444444444444445
/home/dexter/Desktop/blackbuck/LEK_ANNOTATION/still_images/frame270.jpg,1197,1036,1215,1056,1206.0,1046.0,1080,1920,20,18,0,0.628125,0.9685185185185186,0.009375,0.018518518518518517
/home/dexter/Desktop/blackbuck/LEK_ANNOTATION/still_images/frame270.jpg,1282,920,1305,939,1293.5,929.5,1080,1920,19,23,0,0.6736979166666667,0.8606481481481482,0.011979166666666667,0.017592592592592594
/home/dexter/Desktop/blackbuck/LEK_ANNOTATION/still_images/frame270.jpg,1268,881,1292,899,1280.0,890.0,1080,1920,18,24,0,0.6666666666666666,0.8240740740740741,0.0125,0.016666666666666666
/home/dexter/Desktop/blackbuck/LEK_ANNOTATION/still_images/frame270.jpg,1301,876,1320,893,1310.5,884.5,1080,1920,17,19,0,0.6825520833333333,0.8189814814814815,0.009895833333333333,0.01574074074074074
/home/dexter/Desktop/blackbuck/LEK_ANNOTATION/still_images/frame270.jpg,1297,840,1318,858,1307.5,849.0,1080,1920,18,21,0,0.6809895833333334,0.7861111111111111,0.0109375,0.016666666666666666
/home/dexter/Desktop/blackbuck/LEK_ANNOTATION/still_images/frame270.jpg,1388,745,1414,763,1401.0,754.0,1080,1920,18,26,0,0.7296875,0.6981481481481482,0.013541666666666667,0.016666666666666666
/home/dexter/Desktop/blackbuck/LEK_ANNOTATION/still_images/frame270.jpg,1414,721,1434,737,1424.0,729.0,1080,1920,16,20,0,0.7416666666666667,0.675,0.010416666666666666,0.014814814814814815
/home/dexter/Desktop/blackbuck/LEK_ANNOTATION/still_images/frame270.jpg,1441,701,1468,717,1454.5,709.0,1080,1920,16,27,0,0.7575520833333333,0.6564814814814814,0.0140625,0.014814814814814815
/home/dexter/Desktop/blackbuck/LEK_ANNOTATION/still_images/frame270.jpg,1489,656,1512,676,1500.5,666.0,1080,1920,20,23,0,0.7815104166666667,0.6166666666666667,0.011979166666666667,0.018518518518518517
/home/dexter/Desktop/blackbuck/LEK_ANNOTATION/still_images/frame270.jpg,1597,573,1620,594,1608.5,583.5,1080,1920,21,23,0,0.8377604166666667,0.5402777777777777,0.011979166666666667,0.019444444444444445
/home/dexter/Desktop/blackbuck/LEK_ANNOTATION/still_images/frame270.jpg,1685,521,1709,537,1697.0,529.0,1080,1920,16,24,0,0.8838541666666667,0.4898148148148148,0.0125,0.014814814814814815
/home/dexter/Desktop/blackbuck/LEK_ANNOTATION/still_images/frame270.jpg,1837,291,1857,315,1847.0,303.0,1080,1920,24,20,0,0.9619791666666667,0.28055555555555556,0.010416666666666666,0.022222222222222223
/home/dexter/Desktop/blackbuck/LEK_ANNOTATION/still_images/frame270.jpg,1872,256,1893,275,1882.5,265.5,1080,1920,19,21,0,0.98046875,0.24583333333333332,0.0109375,0.017592592592592594
/home/dexter/Desktop/blackbuck/LEK_ANNOTATION/still_images/frame270.jpg,1870,364,1903,380,1886.5,372.0,1080,1920,16,33,0,0.9825520833333333,0.34444444444444444,0.0171875,0.014814814814814815
/home/dexter/Desktop/blackbuck/LEK_ANNOTATION/still_images/frame226.jpg,551,646,568,666,559.5,656.0,1080,1920,20,17,0,0.29140625,0.6074074074074074,0.008854166666666666,0.018518518518518517
/home/dexter/Desktop/blackbuck/LEK_ANNOTATION/still_images/frame226.jpg,590,603,610,621,600.0,612.0,1080,1920,18,20,0,0.3125,0.5666666666666667,0.010416666666666666,0.016666666666666666
/home/dexter/Desktop/blackbuck/LEK_ANNOTATION/still_images/frame226.jpg,622,568,645,582,633.5,575.0,1080,1920,14,23,0,0.3299479166666667,0.5324074074074074,0.011979166666666667,0.012962962962962963
/home/dexter/Desktop/blackbuck/LEK_ANNOTATION/still_images/frame226.jpg,763,535,787,554,775.0,544.5,1080,1920,19,24,0,0.4036458333333333,0.5041666666666667,0.0125,0.017592592592592594
/home/dexter/Desktop/blackbuck/LEK_ANNOTATION/still_images/frame226.jpg,771,443,790,465,780.5,454.0,1080,1920,22,19,0,0.40651041666666665,0.4203703703703704,0.009895833333333333,0.020370370370370372
/home/dexter/Desktop/blackbuck/LEK_ANNOTATION/still_images/frame226.jpg,810,437,834,455,822.0,446.0,1080,1920,18,24,0,0.428125,0.412962962962963,0.0125,0.016666666666666666
/home/dexter/Desktop/blackbuck/LEK_ANNOTATION/still_images/frame226.jpg,821,387,846,403,833.5,395.0,1080,1920,16,25,0,0.43411458333333336,0.36574074074074076,0.013020833333333334,0.014814814814814815
/home/dexter/Desktop/blackbuck/LEK_ANNOTATION/still_images/frame226.jpg,926,306,944,330,935.0,318.0,1080,1920,24,18,0,0.4869791666666667,0.29444444444444445,0.009375,0.022222222222222223
/home/dexter/Desktop/blackbuck/LEK_ANNOTATION/still_images/frame226.jpg,1001,267,1025,284,1013.0,275.5,1080,1920,17,24,0,0.5276041666666667,0.2550925925925926,0.0125,0.01574074074074074
/home/dexter/Desktop/blackbuck/LEK_ANNOTATION/still_images/frame226.jpg,611,1016,631,1038,621.0,1027.0,1080,1920,22,20,0,0.3234375,0.950925925925926,0.010416666666666666,0.020370370370370372
/home/dexter/Desktop/blackbuck/LEK_ANNOTATION/still_images/frame226.jpg,946,726,974,742,960.0,734.0,1080,1920,16,28,0,0.5,0.6796296296296296,0.014583333333333334,0.014814814814814815
/home/dexter/Desktop/blackbuck/LEK_ANNOTATION/still_images/frame226.jpg,854,970,869,998,861.5,984.0,1080,1920,28,15,0,0.44869791666666664,0.9111111111111111,0.0078125,0.025925925925925925
/home/dexter/Desktop/blackbuck/LEK_ANNOTATION/still_images/frame226.jpg,1130,1044,1148,1068,1139.0,1056.0,1080,1920,24,18,0,0.5932291666666667,0.9777777777777777,0.009375,0.022222222222222223
/home/dexter/Desktop/blackbuck/LEK_ANNOTATION/still_images/frame226.jpg,1153,1018,1171,1037,1162.0,1027.5,1080,1920,19,18,0,0.6052083333333333,0.9513888888888888,0.009375,0.017592592592592594
/home/dexter/Desktop/blackbuck/LEK_ANNOTATION/still_images/frame226.jpg,1182,980,1200,1002,1191.0,991.0,1080,1920,22,18,0,0.6203125,0.9175925925925926,0.009375,0.020370370370370372
/home/dexter/Desktop/blackbuck/LEK_ANNOTATION/still_images/frame226.jpg,1198,1035,1212,1059,1205.0,1047.0,1080,1920,24,14,0,0.6276041666666666,0.9694444444444444,0.007291666666666667,0.022222222222222223
/home/dexter/Desktop/blackbuck/LEK_ANNOTATION/still_images/frame226.jpg,1220,928,1244,950,1232.0,939.0,1080,1920,22,24,0,0.6416666666666667,0.8694444444444445,0.0125,0.020370370370370372
/home/dexter/Desktop/blackbuck/LEK_ANNOTATION/still_images/frame226.jpg,1267,929,1289,941,1278.0,935.0,1080,1920,12,22,0,0.665625,0.8657407407407407,0.011458333333333333,0.011111111111111112
/home/dexter/Desktop/blackbuck/LEK_ANNOTATION/still_images/frame226.jpg,1260,889,1282,906,1271.0,897.5,1080,1920,17,22,0,0.6619791666666667,0.8310185185185185,0.011458333333333333,0.01574074074074074
/home/dexter/Desktop/blackbuck/LEK_ANNOTATION/still_images/frame226.jpg,1295,883,1312,904,1303.5,893.5,1080,1920,21,17,0,0.67890625,0.8273148148148148,0.008854166666666666,0.019444444444444445
/home/dexter/Desktop/blackbuck/LEK_ANNOTATION/still_images/frame226.jpg,1293,846,1311,872,1302.0,859.0,1080,1920,26,18,0,0.678125,0.7953703703703704,0.009375,0.024074074074074074
/home/dexter/Desktop/blackbuck/LEK_ANNOTATION/still_images/frame226.jpg,1379,749,1401,771,1390.0,760.0,1080,1920,22,22,0,0.7239583333333334,0.7037037037037037,0.011458333333333333,0.020370370370370372
/home/dexter/Desktop/blackbuck/LEK_ANNOTATION/still_images/frame226.jpg,1406,730,1425,748,1415.5,739.0,1080,1920,18,19,0,0.7372395833333333,0.6842592592592592,0.009895833333333333,0.016666666666666666
/home/dexter/Desktop/blackbuck/LEK_ANNOTATION/still_images/frame226.jpg,1427,707,1458,727,1442.5,717.0,1080,1920,20,31,0,0.7513020833333334,0.6638888888888889,0.016145833333333335,0.018518518518518517
/home/dexter/Desktop/blackbuck/LEK_ANNOTATION/still_images/frame226.jpg,1483,664,1506,688,1494.5,676.0,1080,1920,24,23,0,0.7783854166666667,0.6259259259259259,0.011979166666666667,0.022222222222222223
/home/dexter/Desktop/blackbuck/LEK_ANNOTATION/still_images/frame226.jpg,1585,580,1611,600,1598.0,590.0,1080,1920,20,26,0,0.8322916666666667,0.5462962962962963,0.013541666666666667,0.018518518518518517
/home/dexter/Desktop/blackbuck/LEK_ANNOTATION/still_images/frame226.jpg,1673,524,1700,544,1686.5,534.0,1080,1920,20,27,0,0.8783854166666667,0.49444444444444446,0.0140625,0.018518518518518517
/home/dexter/Desktop/blackbuck/LEK_ANNOTATION/still_images/frame226.jpg,1861,367,1886,386,1873.5,376.5,1080,1920,19,25,0,0.97578125,0.3486111111111111,0.013020833333333334,0.017592592592592594
/home/dexter/Desktop/blackbuck/LEK_ANNOTATION/still_images/frame226.jpg,1824,305,1851,326,1837.5,315.5,1080,1920,21,27,0,0.95703125,0.29212962962962963,0.0140625,0.019444444444444445
/home/dexter/Desktop/blackbuck/LEK_ANNOTATION/still_images/frame226.jpg,1859,267,1886,283,1872.5,275.0,1080,1920,16,27,0,0.9752604166666666,0.25462962962962965,0.0140625,0.014814814814814815
/home/dexter/Desktop/blackbuck/LEK_ANNOTATION/still_images/frame382.jpg,584,616,601,631,592.5,623.5,1080,1920,15,17,0,0.30859375,0.5773148148148148,0.008854166666666666,0.013888888888888888
/home/dexter/Desktop/blackbuck/LEK_ANNOTATION/still_images/frame382.jpg,622,573,644,588,633.0,580.5,1080,1920,15,22,0,0.3296875,0.5375,0.011458333333333333,0.013888888888888888
/home/dexter/Desktop/blackbuck/LEK_ANNOTATION/still_images/frame382.jpg,665,553,689,566,677.0,559.5,1080,1920,13,24,0,0.35260416666666666,0.5180555555555556,0.0125,0.012037037037037037
/home/dexter/Desktop/blackbuck/LEK_ANNOTATION/still_images/frame382.jpg,794,508,809,529,801.5,518.5,1080,1920,21,15,0,0.41744791666666664,0.48009259259259257,0.0078125,0.019444444444444445
/home/dexter/Desktop/blackbuck/LEK_ANNOTATION/still_images/frame382.jpg,805,407,817,424,811.0,415.5,1080,1920,17,12,0,0.42239583333333336,0.38472222222222224,0.00625,0.01574074074074074
/home/dexter/Desktop/blackbuck/LEK_ANNOTATION/still_images/frame382.jpg,855,416,875,431,865.0,423.5,1080,1920,15,20,0,0.4505208333333333,0.3921296296296296,0.010416666666666666,0.013888888888888888
/home/dexter/Desktop/blackbuck/LEK_ANNOTATION/still_images/frame382.jpg,861,356,877,376,869.0,366.0,1080,1920,20,16,0,0.45260416666666664,0.3388888888888889,0.008333333333333333,0.018518518518518517
/home/dexter/Desktop/blackbuck/LEK_ANNOTATION/still_images/frame382.jpg,959,288,979,307,969.0,297.5,1080,1920,19,20,0,0.5046875,0.27546296296296297,0.010416666666666666,0.017592592592592594
/home/dexter/Desktop/blackbuck/LEK_ANNOTATION/still_images/frame382.jpg,1042,254,1064,269,1053.0,261.5,1080,1920,15,22,0,0.5484375,0.24212962962962964,0.011458333333333333,0.013888888888888888
/home/dexter/Desktop/blackbuck/LEK_ANNOTATION/still_images/frame382.jpg,991,712,1011,724,1001.0,718.0,1080,1920,12,20,0,0.5213541666666667,0.6648148148148149,0.010416666666666666,0.011111111111111112
/home/dexter/Desktop/blackbuck/LEK_ANNOTATION/still_images/frame382.jpg,620,1007,636,1028,628.0,1017.5,1080,1920,21,16,0,0.32708333333333334,0.9421296296296297,0.008333333333333333,0.019444444444444445
/home/dexter/Desktop/blackbuck/LEK_ANNOTATION/still_images/frame382.jpg,859,966,871,994,865.0,980.0,1080,1920,28,12,0,0.4505208333333333,0.9074074074074074,0.00625,0.025925925925925925
/home/dexter/Desktop/blackbuck/LEK_ANNOTATION/still_images/frame382.jpg,1105,1059,1129,1078,1117.0,1068.5,1080,1920,19,24,0,0.5817708333333333,0.9893518518518518,0.0125,0.017592592592592594
/home/dexter/Desktop/blackbuck/LEK_ANNOTATION/still_images/frame382.jpg,1135,1036,1153,1060,1144.0,1048.0,1080,1920,24,18,0,0.5958333333333333,0.9703703703703703,0.009375,0.022222222222222223
/home/dexter/Desktop/blackbuck/LEK_ANNOTATION/still_images/frame382.jpg,1162,1005,1183,1025,1172.5,1015.0,1080,1920,20,21,0,0.6106770833333334,0.9398148148148148,0.0109375,0.018518518518518517
/home/dexter/Desktop/blackbuck/LEK_ANNOTATION/still_images/frame382.jpg,1206,1014,1224,1038,1215.0,1026.0,1080,1920,24,18,0,0.6328125,0.95,0.009375,0.022222222222222223
/home/dexter/Desktop/blackbuck/LEK_ANNOTATION/still_images/frame382.jpg,1183,980,1203,999,1193.0,989.5,1080,1920,19,20,0,0.6213541666666667,0.9162037037037037,0.010416666666666666,0.017592592592592594
/home/dexter/Desktop/blackbuck/LEK_ANNOTATION/still_images/frame382.jpg,1213,937,1234,960,1223.5,948.5,1080,1920,23,21,0,0.6372395833333333,0.8782407407407408,0.0109375,0.021296296296296296
/home/dexter/Desktop/blackbuck/LEK_ANNOTATION/still_images/frame382.jpg,1306,901,1332,918,1319.0,909.5,1080,1920,17,26,0,0.6869791666666667,0.8421296296296297,0.013541666666666667,0.01574074074074074
/home/dexter/Desktop/blackbuck/LEK_ANNOTATION/still_images/frame382.jpg,1290,854,1307,873,1298.5,863.5,1080,1920,19,17,0,0.6763020833333333,0.799537037037037,0.008854166666666666,0.017592592592592594
/home/dexter/Desktop/blackbuck/LEK_ANNOTATION/still_images/frame382.jpg,1321,853,1344,872,1332.5,862.5,1080,1920,19,23,0,0.6940104166666666,0.7986111111111112,0.011979166666666667,0.017592592592592594
/home/dexter/Desktop/blackbuck/LEK_ANNOTATION/still_images/frame382.jpg,1416,722,1440,737,1428.0,729.5,1080,1920,15,24,0,0.74375,0.6754629629629629,0.0125,0.013888888888888888
/home/dexter/Desktop/blackbuck/LEK_ANNOTATION/still_images/frame382.jpg,1444,699,1465,713,1454.5,706.0,1080,1920,14,21,0,0.7575520833333333,0.6537037037037037,0.0109375,0.012962962962962963
/home/dexter/Desktop/blackbuck/LEK_ANNOTATION/still_images/frame382.jpg,1258,898,1280,913,1269.0,905.5,1080,1920,15,22,0,0.6609375,0.8384259259259259,0.011458333333333333,0.013888888888888888
/home/dexter/Desktop/blackbuck/LEK_ANNOTATION/still_images/frame382.jpg,1318,816,1339,835,1328.5,825.5,1080,1920,19,21,0,0.6919270833333333,0.7643518518518518,0.0109375,0.017592592592592594
/home/dexter/Desktop/blackbuck/LEK_ANNOTATION/still_images/frame382.jpg,1468,679,1496,697,1482.0,688.0,1080,1920,18,28,0,0.771875,0.6370370370370371,0.014583333333333334,0.016666666666666666
/home/dexter/Desktop/blackbuck/LEK_ANNOTATION/still_images/frame382.jpg,1509,628,1531,645,1520.0,636.5,1080,1920,17,22,0,0.7916666666666666,0.5893518518518519,0.011458333333333333,0.01574074074074074
/home/dexter/Desktop/blackbuck/LEK_ANNOTATION/still_images/frame382.jpg,1619,556,1643,576,1631.0,566.0,1080,1920,20,24,0,0.8494791666666667,0.524074074074074,0.0125,0.018518518518518517
/home/dexter/Desktop/blackbuck/LEK_ANNOTATION/still_images/frame382.jpg,1706,502,1737,523,1721.5,512.5,1080,1920,21,31,0,0.8966145833333333,0.47453703703703703,0.016145833333333335,0.019444444444444445
/home/dexter/Desktop/blackbuck/LEK_ANNOTATION/still_images/frame382.jpg,1857,272,1873,293,1865.0,282.5,1080,1920,21,16,0,0.9713541666666666,0.26157407407407407,0.008333333333333333,0.019444444444444445
/home/dexter/Desktop/blackbuck/LEK_ANNOTATION/still_images/frame382.jpg,1895,240,1918,254,1906.5,247.0,1080,1920,14,23,0,0.99296875,0.22870370370370371,0.011979166666666667,0.012962962962962963
/home/dexter/Desktop/blackbuck/LEK_ANNOTATION/still_images/frame364.jpg,583,617,595,635,589.0,626.0,1080,1920,18,12,0,0.3067708333333333,0.5796296296296296,0.00625,0.016666666666666666
/home/dexter/Desktop/blackbuck/LEK_ANNOTATION/still_images/frame364.jpg,618,573,637,593,627.5,583.0,1080,1920,20,19,0,0.3268229166666667,0.5398148148148149,0.009895833333333333,0.018518518518518517
/home/dexter/Desktop/blackbuck/LEK_ANNOTATION/still_images/frame364.jpg,661,550,686,564,673.5,557.0,1080,1920,14,25,0,0.35078125,0.5157407407407407,0.013020833333333334,0.012962962962962963
/home/dexter/Desktop/blackbuck/LEK_ANNOTATION/still_images/frame364.jpg,790,509,808,531,799.0,520.0,1080,1920,22,18,0,0.4161458333333333,0.48148148148148145,0.009375,0.020370370370370372
/home/dexter/Desktop/blackbuck/LEK_ANNOTATION/still_images/frame364.jpg,795,411,815,433,805.0,422.0,1080,1920,22,20,0,0.4192708333333333,0.3907407407407407,0.010416666666666666,0.020370370370370372
/home/dexter/Desktop/blackbuck/LEK_ANNOTATION/still_images/frame364.jpg,848,423,869,436,858.5,429.5,1080,1920,13,21,0,0.4471354166666667,0.3976851851851852,0.0109375,0.012037037037037037
/home/dexter/Desktop/blackbuck/LEK_ANNOTATION/still_images/frame364.jpg,854,362,876,378,865.0,370.0,1080,1920,16,22,0,0.4505208333333333,0.3425925925925926,0.011458333333333333,0.014814814814814815
/home/dexter/Desktop/blackbuck/LEK_ANNOTATION/still_images/frame364.jpg,955,293,976,306,965.5,299.5,1080,1920,13,21,0,0.5028645833333333,0.2773148148148148,0.0109375,0.012037037037037037
/home/dexter/Desktop/blackbuck/LEK_ANNOTATION/still_images/frame364.jpg,1038,258,1061,275,1049.5,266.5,1080,1920,17,23,0,0.5466145833333333,0.24675925925925926,0.011979166666666667,0.01574074074074074
/home/dexter/Desktop/blackbuck/LEK_ANNOTATION/still_images/frame364.jpg,620,1014,635,1037,627.5,1025.5,1080,1920,23,15,0,0.3268229166666667,0.9495370370370371,0.0078125,0.021296296296296296
/home/dexter/Desktop/blackbuck/LEK_ANNOTATION/still_images/frame364.jpg,840,1012,854,1028,847.0,1020.0,1080,1920,16,14,0,0.44114583333333335,0.9444444444444444,0.007291666666666667,0.014814814814814815
/home/dexter/Desktop/blackbuck/LEK_ANNOTATION/still_images/frame364.jpg,861,969,874,999,867.5,984.0,1080,1920,30,13,0,0.4518229166666667,0.9111111111111111,0.0067708333333333336,0.027777777777777776
/home/dexter/Desktop/blackbuck/LEK_ANNOTATION/still_images/frame364.jpg,984,710,1006,732,995.0,721.0,1080,1920,22,22,0,0.5182291666666666,0.6675925925925926,0.011458333333333333,0.020370370370370372
/home/dexter/Desktop/blackbuck/LEK_ANNOTATION/still_images/frame364.jpg,1106,1064,1127,1078,1116.5,1071.0,1080,1920,14,21,0,0.5815104166666667,0.9916666666666667,0.0109375,0.012962962962962963
/home/dexter/Desktop/blackbuck/LEK_ANNOTATION/still_images/frame364.jpg,1138,1040,1150,1066,1144.0,1053.0,1080,1920,26,12,0,0.5958333333333333,0.975,0.00625,0.024074074074074074
/home/dexter/Desktop/blackbuck/LEK_ANNOTATION/still_images/frame364.jpg,1158,1015,1183,1033,1170.5,1024.0,1080,1920,18,25,0,0.6096354166666667,0.9481481481481482,0.013020833333333334,0.016666666666666666
/home/dexter/Desktop/blackbuck/LEK_ANNOTATION/still_images/frame364.jpg,1182,984,1198,1002,1190.0,993.0,1080,1920,18,16,0,0.6197916666666666,0.9194444444444444,0.008333333333333333,0.016666666666666666
/home/dexter/Desktop/blackbuck/LEK_ANNOTATION/still_images/frame364.jpg,1206,1021,1220,1043,1213.0,1032.0,1080,1920,22,14,0,0.6317708333333333,0.9555555555555556,0.007291666666666667,0.020370370370370372
/home/dexter/Desktop/blackbuck/LEK_ANNOTATION/still_images/frame364.jpg,1208,943,1232,965,1220.0,954.0,1080,1920,22,24,0,0.6354166666666666,0.8833333333333333,0.0125,0.020370370370370372
/home/dexter/Desktop/blackbuck/LEK_ANNOTATION/still_images/frame364.jpg,1253,899,1276,924,1264.5,911.5,1080,1920,25,23,0,0.65859375,0.8439814814814814,0.011979166666666667,0.023148148148148147
/home/dexter/Desktop/blackbuck/LEK_ANNOTATION/still_images/frame364.jpg,1303,906,1328,922,1315.5,914.0,1080,1920,16,25,0,0.68515625,0.8462962962962963,0.013020833333333334,0.014814814814814815
/home/dexter/Desktop/blackbuck/LEK_ANNOTATION/still_images/frame364.jpg,1288,858,1305,883,1296.5,870.5,1080,1920,25,17,0,0.6752604166666667,0.8060185185185185,0.008854166666666666,0.023148148148148147
/home/dexter/Desktop/blackbuck/LEK_ANNOTATION/still_images/frame364.jpg,1318,856,1344,877,1331.0,866.5,1080,1920,21,26,0,0.6932291666666667,0.8023148148148148,0.013541666666666667,0.019444444444444445
/home/dexter/Desktop/blackbuck/LEK_ANNOTATION/still_images/frame364.jpg,1313,819,1338,838,1325.5,828.5,1080,1920,19,25,0,0.6903645833333333,0.7671296296296296,0.013020833333333334,0.017592592592592594
/home/dexter/Desktop/blackbuck/LEK_ANNOTATION/still_images/frame364.jpg,1411,723,1437,742,1424.0,732.5,1080,1920,19,26,0,0.7416666666666667,0.6782407407407407,0.013541666666666667,0.017592592592592594
/home/dexter/Desktop/blackbuck/LEK_ANNOTATION/still_images/frame364.jpg,1440,706,1459,718,1449.5,712.0,1080,1920,12,19,0,0.7549479166666667,0.6592592592592592,0.009895833333333333,0.011111111111111112
/home/dexter/Desktop/blackbuck/LEK_ANNOTATION/still_images/frame364.jpg,1462,687,1492,703,1477.0,695.0,1080,1920,16,30,0,0.7692708333333333,0.6435185185185185,0.015625,0.014814814814814815
/home/dexter/Desktop/blackbuck/LEK_ANNOTATION/still_images/frame364.jpg,1505,632,1529,652,1517.0,642.0,1080,1920,20,24,0,0.7901041666666667,0.5944444444444444,0.0125,0.018518518518518517
/home/dexter/Desktop/blackbuck/LEK_ANNOTATION/still_images/frame364.jpg,1618,562,1639,578,1628.5,570.0,1080,1920,16,21,0,0.8481770833333333,0.5277777777777778,0.0109375,0.014814814814814815
/home/dexter/Desktop/blackbuck/LEK_ANNOTATION/still_images/frame364.jpg,1704,508,1730,525,1717.0,516.5,1080,1920,17,26,0,0.8942708333333333,0.47824074074074074,0.013541666666666667,0.01574074074074074
/home/dexter/Desktop/blackbuck/LEK_ANNOTATION/still_images/frame364.jpg,1853,275,1872,297,1862.5,286.0,1080,1920,22,19,0,0.9700520833333334,0.26481481481481484,0.009895833333333333,0.020370370370370372
/home/dexter/Desktop/blackbuck/LEK_ANNOTATION/still_images/frame364.jpg,1890,245,1917,257,1903.5,251.0,1080,1920,12,27,0,0.99140625,0.2324074074074074,0.0140625,0.011111111111111112
/home/dexter/Desktop/blackbuck/LEK_ANNOTATION/still_images/frame364.jpg,1895,349,1918,368,1906.5,358.5,1080,1920,19,23,0,0.99296875,0.33194444444444443,0.011979166666666667,0.017592592592592594
/home/dexter/Desktop/blackbuck/LEK_ANNOTATION/still_images/frame130.jpg,535,672,552,687,543.5,679.5,1080,1920,15,17,0,0.2830729166666667,0.6291666666666667,0.008854166666666666,0.013888888888888888
/home/dexter/Desktop/blackbuck/LEK_ANNOTATION/still_images/frame130.jpg,573,623,590,643,581.5,633.0,1080,1920,20,17,0,0.3028645833333333,0.5861111111111111,0.008854166666666666,0.018518518518518517
/home/dexter/Desktop/blackbuck/LEK_ANNOTATION/still_images/frame130.jpg,607,584,624,601,615.5,592.5,1080,1920,17,17,0,0.32057291666666665,0.5486111111111112,0.008854166666666666,0.01574074074074074
/home/dexter/Desktop/blackbuck/LEK_ANNOTATION/still_images/frame130.jpg,745,551,764,566,754.5,558.5,1080,1920,15,19,0,0.39296875,0.5171296296296296,0.009895833333333333,0.013888888888888888
/home/dexter/Desktop/blackbuck/LEK_ANNOTATION/still_images/frame130.jpg,742,471,770,490,756.0,480.5,1080,1920,19,28,0,0.39375,0.4449074074074074,0.014583333333333334,0.017592592592592594
/home/dexter/Desktop/blackbuck/LEK_ANNOTATION/still_images/frame130.jpg,780,441,804,458,792.0,449.5,1080,1920,17,24,0,0.4125,0.4162037037037037,0.0125,0.01574074074074074
/home/dexter/Desktop/blackbuck/LEK_ANNOTATION/still_images/frame130.jpg,800,404,825,422,812.5,413.0,1080,1920,18,25,0,0.4231770833333333,0.3824074074074074,0.013020833333333334,0.016666666666666666
/home/dexter/Desktop/blackbuck/LEK_ANNOTATION/still_images/frame130.jpg,902,331,926,351,914.0,341.0,1080,1920,20,24,0,0.47604166666666664,0.31574074074074077,0.0125,0.018518518518518517
/home/dexter/Desktop/blackbuck/LEK_ANNOTATION/still_images/frame130.jpg,976,268,999,286,987.5,277.0,1080,1920,18,23,0,0.5143229166666666,0.2564814814814815,0.011979166666666667,0.016666666666666666
/home/dexter/Desktop/blackbuck/LEK_ANNOTATION/still_images/frame130.jpg,612,1020,625,1037,618.5,1028.5,1080,1920,17,13,0,0.3221354166666667,0.9523148148148148,0.0067708333333333336,0.01574074074074074
/home/dexter/Desktop/blackbuck/LEK_ANNOTATION/still_images/frame130.jpg,922,741,948,753,935.0,747.0,1080,1920,12,26,0,0.4869791666666667,0.6916666666666667,0.013541666666666667,0.011111111111111112
/home/dexter/Desktop/blackbuck/LEK_ANNOTATION/still_images/frame130.jpg,850,969,866,999,858.0,984.0,1080,1920,30,16,0,0.446875,0.9111111111111111,0.008333333333333333,0.027777777777777776
/home/dexter/Desktop/blackbuck/LEK_ANNOTATION/still_images/frame130.jpg,1135,1037,1153,1051,1144.0,1044.0,1080,1920,14,18,0,0.5958333333333333,0.9666666666666667,0.009375,0.012962962962962963
/home/dexter/Desktop/blackbuck/LEK_ANNOTATION/still_images/frame130.jpg,1163,1001,1183,1021,1173.0,1011.0,1080,1920,20,20,0,0.6109375,0.9361111111111111,0.010416666666666666,0.018518518518518517
/home/dexter/Desktop/blackbuck/LEK_ANNOTATION/still_images/frame130.jpg,1190,1048,1207,1074,1198.5,1061.0,1080,1920,26,17,0,0.62421875,0.9824074074074074,0.008854166666666666,0.024074074074074074
/home/dexter/Desktop/blackbuck/LEK_ANNOTATION/still_images/frame130.jpg,1251,943,1272,967,1261.5,955.0,1080,1920,24,21,0,0.65703125,0.8842592592592593,0.0109375,0.022222222222222223
/home/dexter/Desktop/blackbuck/LEK_ANNOTATION/still_images/frame130.jpg,1249,904,1265,924,1257.0,914.0,1080,1920,20,16,0,0.6546875,0.8462962962962963,0.008333333333333333,0.018518518518518517
/home/dexter/Desktop/blackbuck/LEK_ANNOTATION/still_images/frame130.jpg,1276,904,1301,914,1288.5,909.0,1080,1920,10,25,0,0.67109375,0.8416666666666667,0.013020833333333334,0.009259259259259259
/home/dexter/Desktop/blackbuck/LEK_ANNOTATION/still_images/frame130.jpg,1281,871,1304,890,1292.5,880.5,1080,1920,19,23,0,0.6731770833333334,0.8152777777777778,0.011979166666666667,0.017592592592592594
/home/dexter/Desktop/blackbuck/LEK_ANNOTATION/still_images/frame130.jpg,1356,771,1380,789,1368.0,780.0,1080,1920,18,24,0,0.7125,0.7222222222222222,0.0125,0.016666666666666666
/home/dexter/Desktop/blackbuck/LEK_ANNOTATION/still_images/frame130.jpg,1385,753,1401,769,1393.0,761.0,1080,1920,16,16,0,0.7255208333333333,0.7046296296296296,0.008333333333333333,0.014814814814814815
/home/dexter/Desktop/blackbuck/LEK_ANNOTATION/still_images/frame130.jpg,1411,725,1433,743,1422.0,734.0,1080,1920,18,22,0,0.740625,0.6796296296296296,0.011458333333333333,0.016666666666666666
/home/dexter/Desktop/blackbuck/LEK_ANNOTATION/still_images/frame130.jpg,1457,685,1486,705,1471.5,695.0,1080,1920,20,29,0,0.76640625,0.6435185185185185,0.015104166666666667,0.018518518518518517
/home/dexter/Desktop/blackbuck/LEK_ANNOTATION/still_images/frame130.jpg,1558,600,1585,617,1571.5,608.5,1080,1920,17,27,0,0.8184895833333333,0.5634259259259259,0.0140625,0.01574074074074074
/home/dexter/Desktop/blackbuck/LEK_ANNOTATION/still_images/frame130.jpg,1651,539,1678,552,1664.5,545.5,1080,1920,13,27,0,0.8669270833333333,0.5050925925925925,0.0140625,0.012037037037037037
/home/dexter/Desktop/blackbuck/LEK_ANNOTATION/still_images/frame130.jpg,1719,496,1752,512,1735.5,504.0,1080,1920,16,33,0,0.90390625,0.4666666666666667,0.0171875,0.014814814814814815
/home/dexter/Desktop/blackbuck/LEK_ANNOTATION/still_images/frame130.jpg,1833,384,1865,403,1849.0,393.5,1080,1920,19,32,0,0.9630208333333333,0.36435185185185187,0.016666666666666666,0.017592592592592594
/home/dexter/Desktop/blackbuck/LEK_ANNOTATION/still_images/frame130.jpg,1803,328,1829,344,1816.0,336.0,1080,1920,16,26,0,0.9458333333333333,0.3111111111111111,0.013541666666666667,0.014814814814814815
/home/dexter/Desktop/blackbuck/LEK_ANNOTATION/still_images/frame130.jpg,1841,284,1862,303,1851.5,293.5,1080,1920,19,21,0,0.9643229166666667,0.27175925925925926,0.0109375,0.017592592592592594
/home/dexter/Desktop/blackbuck/LEK_ANNOTATION/still_images/frame130.jpg,1888,248,1915,268,1901.5,258.0,1080,1920,20,27,0,0.9903645833333333,0.2388888888888889,0.0140625,0.018518518518518517
/home/dexter/Desktop/blackbuck/LEK_ANNOTATION/still_images/frame242.jpg,554,644,570,664,562.0,654.0,1080,1920,20,16,0,0.29270833333333335,0.6055555555555555,0.008333333333333333,0.018518518518518517
/home/dexter/Desktop/blackbuck/LEK_ANNOTATION/still_images/frame242.jpg,594,602,613,619,603.5,610.5,1080,1920,17,19,0,0.3143229166666667,0.5652777777777778,0.009895833333333333,0.01574074074074074
/home/dexter/Desktop/blackbuck/LEK_ANNOTATION/still_images/frame242.jpg,630,567,651,583,640.5,575.0,1080,1920,16,21,0,0.33359375,0.5324074074074074,0.0109375,0.014814814814814815
/home/dexter/Desktop/blackbuck/LEK_ANNOTATION/still_images/frame242.jpg,771,535,788,550,779.5,542.5,1080,1920,15,17,0,0.40598958333333335,0.5023148148148148,0.008854166666666666,0.013888888888888888
/home/dexter/Desktop/blackbuck/LEK_ANNOTATION/still_images/frame242.jpg,774,438,791,464,782.5,451.0,1080,1920,26,17,0,0.4075520833333333,0.41759259259259257,0.008854166666666666,0.024074074074074074
/home/dexter/Desktop/blackbuck/LEK_ANNOTATION/still_images/frame242.jpg,814,437,840,453,827.0,445.0,1080,1920,16,26,0,0.43072916666666666,0.41203703703703703,0.013541666666666667,0.014814814814814815
/home/dexter/Desktop/blackbuck/LEK_ANNOTATION/still_images/frame242.jpg,826,385,847,401,836.5,393.0,1080,1920,16,21,0,0.4356770833333333,0.3638888888888889,0.0109375,0.014814814814814815
/home/dexter/Desktop/blackbuck/LEK_ANNOTATION/still_images/frame242.jpg,927,305,947,327,937.0,316.0,1080,1920,22,20,0,0.48802083333333335,0.29259259259259257,0.010416666666666666,0.020370370370370372
/home/dexter/Desktop/blackbuck/LEK_ANNOTATION/still_images/frame242.jpg,1001,269,1026,284,1013.5,276.5,1080,1920,15,25,0,0.5278645833333333,0.25601851851851853,0.013020833333333334,0.013888888888888888
/home/dexter/Desktop/blackbuck/LEK_ANNOTATION/still_images/frame242.jpg,953,727,975,744,964.0,735.5,1080,1920,17,22,0,0.5020833333333333,0.6810185185185185,0.011458333333333333,0.01574074074074074
/home/dexter/Desktop/blackbuck/LEK_ANNOTATION/still_images/frame242.jpg,855,972,870,998,862.5,985.0,1080,1920,26,15,0,0.44921875,0.9120370370370371,0.0078125,0.024074074074074074
/home/dexter/Desktop/blackbuck/LEK_ANNOTATION/still_images/frame242.jpg,1135,1039,1150,1065,1142.5,1052.0,1080,1920,26,15,0,0.5950520833333334,0.9740740740740741,0.0078125,0.024074074074074074
/home/dexter/Desktop/blackbuck/LEK_ANNOTATION/still_images/frame242.jpg,1159,1016,1175,1034,1167.0,1025.0,1080,1920,18,16,0,0.6078125,0.9490740740740741,0.008333333333333333,0.016666666666666666
/home/dexter/Desktop/blackbuck/LEK_ANNOTATION/still_images/frame242.jpg,1196,1038,1210,1057,1203.0,1047.5,1080,1920,19,14,0,0.6265625,0.9699074074074074,0.007291666666666667,0.017592592592592594
/home/dexter/Desktop/blackbuck/LEK_ANNOTATION/still_images/frame242.jpg,1182,982,1204,1000,1193.0,991.0,1080,1920,18,22,0,0.6213541666666667,0.9175925925925926,0.011458333333333333,0.016666666666666666
/home/dexter/Desktop/blackbuck/LEK_ANNOTATION/still_images/frame242.jpg,1228,925,1246,949,1237.0,937.0,1080,1920,24,18,0,0.6442708333333333,0.8675925925925926,0.009375,0.022222222222222223
/home/dexter/Desktop/blackbuck/LEK_ANNOTATION/still_images/frame242.jpg,1274,928,1303,944,1288.5,936.0,1080,1920,16,29,0,0.67109375,0.8666666666666667,0.015104166666666667,0.014814814814814815
/home/dexter/Desktop/blackbuck/LEK_ANNOTATION/still_images/frame242.jpg,1267,887,1286,907,1276.5,897.0,1080,1920,20,19,0,0.66484375,0.8305555555555556,0.009895833333333333,0.018518518518518517
/home/dexter/Desktop/blackbuck/LEK_ANNOTATION/still_images/frame242.jpg,1296,880,1319,901,1307.5,890.5,1080,1920,21,23,0,0.6809895833333334,0.8245370370370371,0.011979166666666667,0.019444444444444445
/home/dexter/Desktop/blackbuck/LEK_ANNOTATION/still_images/frame242.jpg,1292,842,1313,866,1302.5,854.0,1080,1920,24,21,0,0.6783854166666666,0.7907407407407407,0.0109375,0.022222222222222223
/home/dexter/Desktop/blackbuck/LEK_ANNOTATION/still_images/frame242.jpg,1384,748,1408,767,1396.0,757.5,1080,1920,19,24,0,0.7270833333333333,0.7013888888888888,0.0125,0.017592592592592594
/home/dexter/Desktop/blackbuck/LEK_ANNOTATION/still_images/frame242.jpg,1412,727,1428,745,1420.0,736.0,1080,1920,18,16,0,0.7395833333333334,0.6814814814814815,0.008333333333333333,0.016666666666666666
/home/dexter/Desktop/blackbuck/LEK_ANNOTATION/still_images/frame242.jpg,1437,704,1458,724,1447.5,714.0,1080,1920,20,21,0,0.75390625,0.6611111111111111,0.0109375,0.018518518518518517
/home/dexter/Desktop/blackbuck/LEK_ANNOTATION/still_images/frame242.jpg,1489,659,1509,687,1499.0,673.0,1080,1920,28,20,0,0.7807291666666667,0.6231481481481481,0.010416666666666666,0.025925925925925925
/home/dexter/Desktop/blackbuck/LEK_ANNOTATION/still_images/frame242.jpg,1590,579,1612,597,1601.0,588.0,1080,1920,18,22,0,0.8338541666666667,0.5444444444444444,0.011458333333333333,0.016666666666666666
/home/dexter/Desktop/blackbuck/LEK_ANNOTATION/still_images/frame242.jpg,1678,524,1702,540,1690.0,532.0,1080,1920,16,24,0,0.8802083333333334,0.4925925925925926,0.0125,0.014814814814814815
/home/dexter/Desktop/blackbuck/LEK_ANNOTATION/still_images/frame242.jpg,1860,367,1891,387,1875.5,377.0,1080,1920,20,31,0,0.9768229166666667,0.3490740740740741,0.016145833333333335,0.018518518518518517
/home/dexter/Desktop/blackbuck/LEK_ANNOTATION/still_images/frame242.jpg,1832,304,1853,324,1842.5,314.0,1080,1920,20,21,0,0.9596354166666666,0.29074074074074074,0.0109375,0.018518518518518517
/home/dexter/Desktop/blackbuck/LEK_ANNOTATION/still_images/frame242.jpg,1864,264,1892,280,1878.0,272.0,1080,1920,16,28,0,0.978125,0.2518518518518518,0.014583333333333334,0.014814814814814815
/home/dexter/Desktop/blackbuck/LEK_ANNOTATION/still_images/frame242.jpg,616,1020,629,1039,622.5,1029.5,1080,1920,19,13,0,0.32421875,0.9532407407407407,0.0067708333333333336,0.017592592592592594
/home/dexter/Desktop/blackbuck/LEK_ANNOTATION/still_images/frame608.jpg,587,607,608,629,597.5,618.0,1080,1920,22,21,0,0.3111979166666667,0.5722222222222222,0.0109375,0.020370370370370372
/home/dexter/Desktop/blackbuck/LEK_ANNOTATION/still_images/frame608.jpg,625,570,647,584,636.0,577.0,1080,1920,14,22,0,0.33125,0.5342592592592592,0.011458333333333333,0.012962962962962963
/home/dexter/Desktop/blackbuck/LEK_ANNOTATION/still_images/frame608.jpg,676,531,699,543,687.5,537.0,1080,1920,12,23,0,0.3580729166666667,0.49722222222222223,0.011979166666666667,0.011111111111111112
/home/dexter/Desktop/blackbuck/LEK_ANNOTATION/still_images/frame608.jpg,725,530,750,548,737.5,539.0,1080,1920,18,25,0,0.3841145833333333,0.49907407407407406,0.013020833333333334,0.016666666666666666
/home/dexter/Desktop/blackbuck/LEK_ANNOTATION/still_images/frame608.jpg,834,468,858,485,846.0,476.5,1080,1920,17,24,0,0.440625,0.4412037037037037,0.0125,0.01574074074074074
/home/dexter/Desktop/blackbuck/LEK_ANNOTATION/still_images/frame608.jpg,855,360,881,380,868.0,370.0,1080,1920,20,26,0,0.45208333333333334,0.3425925925925926,0.013541666666666667,0.018518518518518517
/home/dexter/Desktop/blackbuck/LEK_ANNOTATION/still_images/frame608.jpg,900,390,922,409,911.0,399.5,1080,1920,19,22,0,0.4744791666666667,0.3699074074074074,0.011458333333333333,0.017592592592592594
/home/dexter/Desktop/blackbuck/LEK_ANNOTATION/still_images/frame608.jpg,913,319,934,337,923.5,328.0,1080,1920,18,21,0,0.48098958333333336,0.3037037037037037,0.0109375,0.016666666666666666
/home/dexter/Desktop/blackbuck/LEK_ANNOTATION/still_images/frame608.jpg,1023,258,1051,275,1037.0,266.5,1080,1920,17,28,0,0.5401041666666667,0.24675925925925926,0.014583333333333334,0.01574074074074074
/home/dexter/Desktop/blackbuck/LEK_ANNOTATION/still_images/frame608.jpg,1108,241,1133,258,1120.5,249.5,1080,1920,17,25,0,0.58359375,0.2310185185185185,0.013020833333333334,0.01574074074074074
/home/dexter/Desktop/blackbuck/LEK_ANNOTATION/still_images/frame608.jpg,680,983,704,996,692.0,989.5,1080,1920,13,24,0,0.36041666666666666,0.9162037037037037,0.0125,0.012037037037037037
/home/dexter/Desktop/blackbuck/LEK_ANNOTATION/still_images/frame608.jpg,864,964,881,992,872.5,978.0,1080,1920,28,17,0,0.4544270833333333,0.9055555555555556,0.008854166666666666,0.025925925925925925
/home/dexter/Desktop/blackbuck/LEK_ANNOTATION/still_images/frame608.jpg,1039,663,1072,690,1055.5,676.5,1080,1920,27,33,0,0.5497395833333333,0.6263888888888889,0.0171875,0.025
/home/dexter/Desktop/blackbuck/LEK_ANNOTATION/still_images/frame608.jpg,1809,469,1841,490,1825.0,479.5,1080,1920,21,32,0,0.9505208333333334,0.4439814814814815,0.016666666666666666,0.019444444444444445
/home/dexter/Desktop/blackbuck/LEK_ANNOTATION/still_images/frame608.jpg,1758,489,1782,508,1770.0,498.5,1080,1920,19,24,0,0.921875,0.4615740740740741,0.0125,0.017592592592592594
/home/dexter/Desktop/blackbuck/LEK_ANNOTATION/still_images/frame608.jpg,1679,518,1708,535,1693.5,526.5,1080,1920,17,29,0,0.88203125,0.4875,0.015104166666666667,0.01574074074074074
/home/dexter/Desktop/blackbuck/LEK_ANNOTATION/still_images/frame608.jpg,1566,588,1599,611,1582.5,599.5,1080,1920,23,33,0,0.82421875,0.5550925925925926,0.0171875,0.021296296296296296
/home/dexter/Desktop/blackbuck/LEK_ANNOTATION/still_images/frame608.jpg,1513,621,1541,642,1527.0,631.5,1080,1920,21,28,0,0.7953125,0.5847222222222223,0.014583333333333334,0.019444444444444445
/home/dexter/Desktop/blackbuck/LEK_ANNOTATION/still_images/frame608.jpg,1489,648,1519,670,1504.0,659.0,1080,1920,22,30,0,0.7833333333333333,0.6101851851851852,0.015625,0.020370370370370372
/home/dexter/Desktop/blackbuck/LEK_ANNOTATION/still_images/frame608.jpg,1473,679,1506,701,1489.5,690.0,1080,1920,22,33,0,0.77578125,0.6388888888888888,0.0171875,0.020370370370370372
/home/dexter/Desktop/blackbuck/LEK_ANNOTATION/still_images/frame608.jpg,1327,808,1356,825,1341.5,816.5,1080,1920,17,29,0,0.6986979166666667,0.7560185185185185,0.015104166666666667,0.01574074074074074
/home/dexter/Desktop/blackbuck/LEK_ANNOTATION/still_images/frame608.jpg,1374,809,1400,832,1387.0,820.5,1080,1920,23,26,0,0.7223958333333333,0.7597222222222222,0.013541666666666667,0.021296296296296296
/home/dexter/Desktop/blackbuck/LEK_ANNOTATION/still_images/frame608.jpg,1360,854,1381,878,1370.5,866.0,1080,1920,24,21,0,0.7138020833333333,0.8018518518518518,0.0109375,0.022222222222222223
/home/dexter/Desktop/blackbuck/LEK_ANNOTATION/still_images/frame608.jpg,1306,835,1320,859,1313.0,847.0,1080,1920,24,14,0,0.6838541666666667,0.7842592592592592,0.007291666666666667,0.022222222222222223
/home/dexter/Desktop/blackbuck/LEK_ANNOTATION/still_images/frame608.jpg,1362,771,1384,799,1373.0,785.0,1080,1920,28,22,0,0.7151041666666667,0.7268518518518519,0.011458333333333333,0.025925925925925925
/home/dexter/Desktop/blackbuck/LEK_ANNOTATION/still_images/frame608.jpg,1264,888,1290,914,1277.0,901.0,1080,1920,26,26,0,0.6651041666666667,0.8342592592592593,0.013541666666666667,0.024074074074074074
/home/dexter/Desktop/blackbuck/LEK_ANNOTATION/still_images/frame608.jpg,1230,926,1253,949,1241.5,937.5,1080,1920,23,23,0,0.6466145833333333,0.8680555555555556,0.011979166666666667,0.021296296296296296
/home/dexter/Desktop/blackbuck/LEK_ANNOTATION/still_images/frame608.jpg,1213,949,1233,967,1223.0,958.0,1080,1920,18,20,0,0.6369791666666667,0.8870370370370371,0.010416666666666666,0.016666666666666666
/home/dexter/Desktop/blackbuck/LEK_ANNOTATION/still_images/frame608.jpg,1182,985,1206,1005,1194.0,995.0,1080,1920,20,24,0,0.621875,0.9212962962962963,0.0125,0.018518518518518517
/home/dexter/Desktop/blackbuck/LEK_ANNOTATION/still_images/frame608.jpg,1246,979,1270,997,1258.0,988.0,1080,1920,18,24,0,0.6552083333333333,0.9148148148148149,0.0125,0.016666666666666666
/home/dexter/Desktop/blackbuck/LEK_ANNOTATION/still_images/frame608.jpg,1161,1018,1180,1031,1170.5,1024.5,1080,1920,13,19,0,0.6096354166666667,0.9486111111111111,0.009895833333333333,0.012037037037037037
/home/dexter/Desktop/blackbuck/LEK_ANNOTATION/still_images/frame608.jpg,1142,1036,1164,1052,1153.0,1044.0,1080,1920,16,22,0,0.6005208333333333,0.9666666666666667,0.011458333333333333,0.014814814814814815
/home/dexter/Desktop/blackbuck/LEK_ANNOTATION/still_images/frame608.jpg,1130,1048,1147,1063,1138.5,1055.5,1080,1920,15,17,0,0.59296875,0.9773148148148149,0.008854166666666666,0.013888888888888888
/home/dexter/Desktop/blackbuck/LEK_ANNOTATION/still_images/frame608.jpg,1116,1066,1130,1077,1123.0,1071.5,1080,1920,11,14,0,0.5848958333333333,0.9921296296296296,0.007291666666666667,0.010185185185185186
/home/dexter/Desktop/blackbuck/LEK_ANNOTATION/still_images/frame624.jpg,630,565,648,581,639.0,573.0,1080,1920,16,18,0,0.3328125,0.5305555555555556,0.009375,0.014814814814814815
/home/dexter/Desktop/blackbuck/LEK_ANNOTATION/still_images/frame624.jpg,678,524,699,541,688.5,532.5,1080,1920,17,21,0,0.35859375,0.4930555555555556,0.0109375,0.01574074074074074
/home/dexter/Desktop/blackbuck/LEK_ANNOTATION/still_images/frame624.jpg,730,528,753,546,741.5,537.0,1080,1920,18,23,0,0.38619791666666664,0.49722222222222223,0.011979166666666667,0.016666666666666666
/home/dexter/Desktop/blackbuck/LEK_ANNOTATION/still_images/frame624.jpg,841,465,858,484,849.5,474.5,1080,1920,19,17,0,0.44244791666666666,0.4393518518518518,0.008854166666666666,0.017592592592592594
/home/dexter/Desktop/blackbuck/LEK_ANNOTATION/still_images/frame624.jpg,859,357,883,375,871.0,366.0,1080,1920,18,24,0,0.45364583333333336,0.3388888888888889,0.0125,0.016666666666666666
/home/dexter/Desktop/blackbuck/LEK_ANNOTATION/still_images/frame624.jpg,905,390,923,410,914.0,400.0,1080,1920,20,18,0,0.47604166666666664,0.37037037037037035,0.009375,0.018518518518518517
/home/dexter/Desktop/blackbuck/LEK_ANNOTATION/still_images/frame624.jpg,919,316,941,335,930.0,325.5,1080,1920,19,22,0,0.484375,0.3013888888888889,0.011458333333333333,0.017592592592592594
/home/dexter/Desktop/blackbuck/LEK_ANNOTATION/still_images/frame624.jpg,1024,256,1053,276,1038.5,266.0,1080,1920,20,29,0,0.5408854166666667,0.2462962962962963,0.015104166666666667,0.018518518518518517
/home/dexter/Desktop/blackbuck/LEK_ANNOTATION/still_images/frame624.jpg,1111,240,1137,259,1124.0,249.5,1080,1920,19,26,0,0.5854166666666667,0.2310185185185185,0.013541666666666667,0.017592592592592594
/home/dexter/Desktop/blackbuck/LEK_ANNOTATION/still_images/frame624.jpg,686,978,706,994,696.0,986.0,1080,1920,16,20,0,0.3625,0.912962962962963,0.010416666666666666,0.014814814814814815
/home/dexter/Desktop/blackbuck/LEK_ANNOTATION/still_images/frame624.jpg,864,964,881,991,872.5,977.5,1080,1920,27,17,0,0.4544270833333333,0.9050925925925926,0.008854166666666666,0.025
/home/dexter/Desktop/blackbuck/LEK_ANNOTATION/still_images/frame624.jpg,1046,659,1067,685,1056.5,672.0,1080,1920,26,21,0,0.5502604166666667,0.6222222222222222,0.0109375,0.024074074074074074
/home/dexter/Desktop/blackbuck/LEK_ANNOTATION/still_images/frame624.jpg,1114,1061,1133,1078,1123.5,1069.5,1080,1920,17,19,0,0.58515625,0.9902777777777778,0.009895833333333333,0.01574074074074074
/home/dexter/Desktop/blackbuck/LEK_ANNOTATION/still_images/frame624.jpg,1132,1041,1150,1062,1141.0,1051.5,1080,1920,21,18,0,0.5942708333333333,0.9736111111111111,0.009375,0.019444444444444445
/home/dexter/Desktop/blackbuck/LEK_ANNOTATION/still_images/frame624.jpg,1147,1032,1165,1049,1156.0,1040.5,1080,1920,17,18,0,0.6020833333333333,0.9634259259259259,0.009375,0.01574074074074074
/home/dexter/Desktop/blackbuck/LEK_ANNOTATION/still_images/frame624.jpg,1159,1015,1185,1032,1172.0,1023.5,1080,1920,17,26,0,0.6104166666666667,0.9476851851851852,0.013541666666666667,0.01574074074074074
/home/dexter/Desktop/blackbuck/LEK_ANNOTATION/still_images/frame624.jpg,1187,982,1212,1003,1199.5,992.5,1080,1920,21,25,0,0.6247395833333333,0.9189814814814815,0.013020833333333334,0.019444444444444445
/home/dexter/Desktop/blackbuck/LEK_ANNOTATION/still_images/frame624.jpg,1216,944,1238,964,1227.0,954.0,1080,1920,20,22,0,0.6390625,0.8833333333333333,0.011458333333333333,0.018518518518518517
/home/dexter/Desktop/blackbuck/LEK_ANNOTATION/still_images/frame624.jpg,1237,925,1255,945,1246.0,935.0,1080,1920,20,18,0,0.6489583333333333,0.8657407407407407,0.009375,0.018518518518518517
/home/dexter/Desktop/blackbuck/LEK_ANNOTATION/still_images/frame624.jpg,1248,973,1272,993,1260.0,983.0,1080,1920,20,24,0,0.65625,0.9101851851851852,0.0125,0.018518518518518517
/home/dexter/Desktop/blackbuck/LEK_ANNOTATION/still_images/frame624.jpg,1267,894,1290,912,1278.5,903.0,1080,1920,18,23,0,0.6658854166666667,0.8361111111111111,0.011979166666666667,0.016666666666666666
/home/dexter/Desktop/blackbuck/LEK_ANNOTATION/still_images/frame624.jpg,1365,849,1384,872,1374.5,860.5,1080,1920,23,19,0,0.7158854166666667,0.7967592592592593,0.009895833333333333,0.021296296296296296
/home/dexter/Desktop/blackbuck/LEK_ANNOTATION/still_images/frame624.jpg,1332,806,1356,823,1344.0,814.5,1080,1920,17,24,0,0.7,0.7541666666666667,0.0125,0.01574074074074074
/home/dexter/Desktop/blackbuck/LEK_ANNOTATION/still_images/frame624.jpg,1379,806,1399,832,1389.0,819.0,1080,1920,26,20,0,0.7234375,0.7583333333333333,0.010416666666666666,0.024074074074074074
/home/dexter/Desktop/blackbuck/LEK_ANNOTATION/still_images/frame624.jpg,1365,774,1385,795,1375.0,784.5,1080,1920,21,20,0,0.7161458333333334,0.7263888888888889,0.010416666666666666,0.019444444444444445
/home/dexter/Desktop/blackbuck/LEK_ANNOTATION/still_images/frame624.jpg,1481,676,1508,694,1494.5,685.0,1080,1920,18,27,0,0.7783854166666667,0.6342592592592593,0.0140625,0.016666666666666666
/home/dexter/Desktop/blackbuck/LEK_ANNOTATION/still_images/frame624.jpg,1507,647,1522,667,1514.5,657.0,1080,1920,20,15,0,0.7888020833333333,0.6083333333333333,0.0078125,0.018518518518518517
/home/dexter/Desktop/blackbuck/LEK_ANNOTATION/still_images/frame624.jpg,1522,620,1544,648,1533.0,634.0,1080,1920,28,22,0,0.7984375,0.587037037037037,0.011458333333333333,0.025925925925925925
/home/dexter/Desktop/blackbuck/LEK_ANNOTATION/still_images/frame624.jpg,1574,591,1603,612,1588.5,601.5,1080,1920,21,29,0,0.82734375,0.5569444444444445,0.015104166666666667,0.019444444444444445
/home/dexter/Desktop/blackbuck/LEK_ANNOTATION/still_images/frame624.jpg,1683,516,1708,534,1695.5,525.0,1080,1920,18,25,0,0.8830729166666667,0.4861111111111111,0.013020833333333334,0.016666666666666666
/home/dexter/Desktop/blackbuck/LEK_ANNOTATION/still_images/frame624.jpg,1761,486,1786,503,1773.5,494.5,1080,1920,17,25,0,0.9236979166666667,0.45787037037037037,0.013020833333333334,0.01574074074074074
/home/dexter/Desktop/blackbuck/LEK_ANNOTATION/still_images/frame624.jpg,1813,470,1844,485,1828.5,477.5,1080,1920,15,31,0,0.95234375,0.44212962962962965,0.016145833333333335,0.013888888888888888
/home/dexter/Desktop/blackbuck/LEK_ANNOTATION/still_images/frame112.jpg,532,674,548,692,540.0,683.0,1080,1920,18,16,0,0.28125,0.6324074074074074,0.008333333333333333,0.016666666666666666
/home/dexter/Desktop/blackbuck/LEK_ANNOTATION/still_images/frame112.jpg,571,630,588,650,579.5,640.0,1080,1920,20,17,0,0.30182291666666666,0.5925925925925926,0.008854166666666666,0.018518518518518517
/home/dexter/Desktop/blackbuck/LEK_ANNOTATION/still_images/frame112.jpg,602,588,623,607,612.5,597.5,1080,1920,19,21,0,0.3190104166666667,0.5532407407407407,0.0109375,0.017592592592592594
/home/dexter/Desktop/blackbuck/LEK_ANNOTATION/still_images/frame112.jpg,739,555,761,574,750.0,564.5,1080,1920,19,22,0,0.390625,0.5226851851851851,0.011458333333333333,0.017592592592592594
/home/dexter/Desktop/blackbuck/LEK_ANNOTATION/still_images/frame112.jpg,744,471,761,492,752.5,481.5,1080,1920,21,17,0,0.3919270833333333,0.44583333333333336,0.008854166666666666,0.019444444444444445
/home/dexter/Desktop/blackbuck/LEK_ANNOTATION/still_images/frame112.jpg,777,447,799,463,788.0,455.0,1080,1920,16,22,0,0.41041666666666665,0.4212962962962963,0.011458333333333333,0.014814814814814815
/home/dexter/Desktop/blackbuck/LEK_ANNOTATION/still_images/frame112.jpg,800,409,817,425,808.5,417.0,1080,1920,16,17,0,0.42109375,0.3861111111111111,0.008854166666666666,0.014814814814814815
/home/dexter/Desktop/blackbuck/LEK_ANNOTATION/still_images/frame112.jpg,899,333,921,352,910.0,342.5,1080,1920,19,22,0,0.4739583333333333,0.31712962962962965,0.011458333333333333,0.017592592592592594
/home/dexter/Desktop/blackbuck/LEK_ANNOTATION/still_images/frame112.jpg,964,269,994,285,979.0,277.0,1080,1920,16,30,0,0.5098958333333333,0.2564814814814815,0.015625,0.014814814814814815
/home/dexter/Desktop/blackbuck/LEK_ANNOTATION/still_images/frame112.jpg,915,743,944,757,929.5,750.0,1080,1920,14,29,0,0.48411458333333335,0.6944444444444444,0.015104166666666667,0.012962962962962963
/home/dexter/Desktop/blackbuck/LEK_ANNOTATION/still_images/frame112.jpg,609,1019,627,1039,618.0,1029.0,1080,1920,20,18,0,0.321875,0.9527777777777777,0.009375,0.018518518518518517
/home/dexter/Desktop/blackbuck/LEK_ANNOTATION/still_images/frame112.jpg,850,971,865,1001,857.5,986.0,1080,1920,30,15,0,0.4466145833333333,0.912962962962963,0.0078125,0.027777777777777776
/home/dexter/Desktop/blackbuck/LEK_ANNOTATION/still_images/frame112.jpg,1131,1039,1150,1058,1140.5,1048.5,1080,1920,19,19,0,0.5940104166666667,0.9708333333333333,0.009895833333333333,0.017592592592592594
/home/dexter/Desktop/blackbuck/LEK_ANNOTATION/still_images/frame112.jpg,1185,1052,1206,1077,1195.5,1064.5,1080,1920,25,21,0,0.62265625,0.9856481481481482,0.0109375,0.023148148148148147
/home/dexter/Desktop/blackbuck/LEK_ANNOTATION/still_images/frame112.jpg,1158,1006,1179,1024,1168.5,1015.0,1080,1920,18,21,0,0.60859375,0.9398148148148148,0.0109375,0.016666666666666666
/home/dexter/Desktop/blackbuck/LEK_ANNOTATION/still_images/frame112.jpg,1203,955,1224,984,1213.5,969.5,1080,1920,29,21,0,0.63203125,0.8976851851851851,0.0109375,0.026851851851851852
/home/dexter/Desktop/blackbuck/LEK_ANNOTATION/still_images/frame112.jpg,1245,945,1269,969,1257.0,957.0,1080,1920,24,24,0,0.6546875,0.8861111111111111,0.0125,0.022222222222222223
/home/dexter/Desktop/blackbuck/LEK_ANNOTATION/still_images/frame112.jpg,1240,909,1264,924,1252.0,916.5,1080,1920,15,24,0,0.6520833333333333,0.8486111111111111,0.0125,0.013888888888888888
/home/dexter/Desktop/blackbuck/LEK_ANNOTATION/still_images/frame112.jpg,1271,901,1297,917,1284.0,909.0,1080,1920,16,26,0,0.66875,0.8416666666666667,0.013541666666666667,0.014814814814814815
/home/dexter/Desktop/blackbuck/LEK_ANNOTATION/still_images/frame112.jpg,1278,875,1304,892,1291.0,883.5,1080,1920,17,26,0,0.6723958333333333,0.8180555555555555,0.013541666666666667,0.01574074074074074
/home/dexter/Desktop/blackbuck/LEK_ANNOTATION/still_images/frame112.jpg,1351,774,1375,795,1363.0,784.5,1080,1920,21,24,0,0.7098958333333333,0.7263888888888889,0.0125,0.019444444444444445
/home/dexter/Desktop/blackbuck/LEK_ANNOTATION/still_images/frame112.jpg,1376,751,1398,772,1387.0,761.5,1080,1920,21,22,0,0.7223958333333333,0.7050925925925926,0.011458333333333333,0.019444444444444445
/home/dexter/Desktop/blackbuck/LEK_ANNOTATION/still_images/frame112.jpg,1400,726,1427,750,1413.5,738.0,1080,1920,24,27,0,0.7361979166666667,0.6833333333333333,0.0140625,0.022222222222222223
/home/dexter/Desktop/blackbuck/LEK_ANNOTATION/still_images/frame112.jpg,1453,685,1481,705,1467.0,695.0,1080,1920,20,28,0,0.7640625,0.6435185185185185,0.014583333333333334,0.018518518518518517
/home/dexter/Desktop/blackbuck/LEK_ANNOTATION/still_images/frame112.jpg,1558,602,1582,617,1570.0,609.5,1080,1920,15,24,0,0.8177083333333334,0.5643518518518519,0.0125,0.013888888888888888
/home/dexter/Desktop/blackbuck/LEK_ANNOTATION/still_images/frame112.jpg,1638,540,1672,558,1655.0,549.0,1080,1920,18,34,0,0.8619791666666666,0.5083333333333333,0.017708333333333333,0.016666666666666666
/home/dexter/Desktop/blackbuck/LEK_ANNOTATION/still_images/frame112.jpg,1717,496,1748,513,1732.5,504.5,1080,1920,17,31,0,0.90234375,0.4671296296296296,0.016145833333333335,0.01574074074074074
/home/dexter/Desktop/blackbuck/LEK_ANNOTATION/still_images/frame112.jpg,1831,382,1860,403,1845.5,392.5,1080,1920,21,29,0,0.9611979166666667,0.36342592592592593,0.015104166666666667,0.019444444444444445
/home/dexter/Desktop/blackbuck/LEK_ANNOTATION/still_images/frame112.jpg,1800,329,1825,347,1812.5,338.0,1080,1920,18,25,0,0.9440104166666666,0.31296296296296294,0.013020833333333334,0.016666666666666666
/home/dexter/Desktop/blackbuck/LEK_ANNOTATION/still_images/frame112.jpg,1835,288,1859,311,1847.0,299.5,1080,1920,23,24,0,0.9619791666666667,0.2773148148148148,0.0125,0.021296296296296296
/home/dexter/Desktop/blackbuck/LEK_ANNOTATION/still_images/frame112.jpg,1886,251,1909,277,1897.5,264.0,1080,1920,26,23,0,0.98828125,0.24444444444444444,0.011979166666666667,0.024074074074074074
/home/dexter/Desktop/blackbuck/LEK_ANNOTATION/still_images/frame16.jpg,508,693,528,710,518.0,701.5,1080,1920,17,20,0,0.26979166666666665,0.649537037037037,0.010416666666666666,0.01574074074074074
/home/dexter/Desktop/blackbuck/LEK_ANNOTATION/still_images/frame16.jpg,547,645,565,665,556.0,655.0,1080,1920,20,18,0,0.28958333333333336,0.6064814814814815,0.009375,0.018518518518518517
/home/dexter/Desktop/blackbuck/LEK_ANNOTATION/still_images/frame16.jpg,581,608,599,628,590.0,618.0,1080,1920,20,18,0,0.3072916666666667,0.5722222222222222,0.009375,0.018518518518518517
/home/dexter/Desktop/blackbuck/LEK_ANNOTATION/still_images/frame16.jpg,721,567,737,591,729.0,579.0,1080,1920,24,16,0,0.3796875,0.5361111111111111,0.008333333333333333,0.022222222222222223
/home/dexter/Desktop/blackbuck/LEK_ANNOTATION/still_images/frame16.jpg,713,492,739,507,726.0,499.5,1080,1920,15,26,0,0.378125,0.4625,0.013541666666666667,0.013888888888888888
/home/dexter/Desktop/blackbuck/LEK_ANNOTATION/still_images/frame16.jpg,752,460,771,478,761.5,469.0,1080,1920,18,19,0,0.3966145833333333,0.43425925925925923,0.009895833333333333,0.016666666666666666
/home/dexter/Desktop/blackbuck/LEK_ANNOTATION/still_images/frame16.jpg,780,428,795,446,787.5,437.0,1080,1920,18,15,0,0.41015625,0.4046296296296296,0.0078125,0.016666666666666666
/home/dexter/Desktop/blackbuck/LEK_ANNOTATION/still_images/frame16.jpg,876,344,897,361,886.5,352.5,1080,1920,17,21,0,0.46171875,0.3263888888888889,0.0109375,0.01574074074074074
/home/dexter/Desktop/blackbuck/LEK_ANNOTATION/still_images/frame16.jpg,944,269,963,291,953.5,280.0,1080,1920,22,19,0,0.49661458333333336,0.25925925925925924,0.009895833333333333,0.020370370370370372
/home/dexter/Desktop/blackbuck/LEK_ANNOTATION/still_images/frame16.jpg,889,755,915,773,902.0,764.0,1080,1920,18,26,0,0.46979166666666666,0.7074074074074074,0.013541666666666667,0.016666666666666666
/home/dexter/Desktop/blackbuck/LEK_ANNOTATION/still_images/frame16.jpg,609,1017,624,1040,616.5,1028.5,1080,1920,23,15,0,0.32109375,0.9523148148148148,0.0078125,0.021296296296296296
/home/dexter/Desktop/blackbuck/LEK_ANNOTATION/still_images/frame16.jpg,846,970,865,1002,855.5,986.0,1080,1920,32,19,0,0.44557291666666665,0.912962962962963,0.009895833333333333,0.02962962962962963
/home/dexter/Desktop/blackbuck/LEK_ANNOTATION/still_images/frame16.jpg,1107,1058,1131,1073,1119.0,1065.5,1080,1920,15,24,0,0.5828125,0.986574074074074,0.0125,0.013888888888888888
/home/dexter/Desktop/blackbuck/LEK_ANNOTATION/still_images/frame16.jpg,1137,1025,1157,1049,1147.0,1037.0,1080,1920,24,20,0,0.5973958333333333,0.9601851851851851,0.010416666666666666,0.022222222222222223
/home/dexter/Desktop/blackbuck/LEK_ANNOTATION/still_images/frame16.jpg,1178,980,1205,997,1191.5,988.5,1080,1920,17,27,0,0.6205729166666667,0.9152777777777777,0.0140625,0.01574074074074074
/home/dexter/Desktop/blackbuck/LEK_ANNOTATION/still_images/frame16.jpg,1232,969,1250,992,1241.0,980.5,1080,1920,23,18,0,0.6463541666666667,0.9078703703703703,0.009375,0.021296296296296296
/home/dexter/Desktop/blackbuck/LEK_ANNOTATION/still_images/frame16.jpg,1219,924,1248,945,1233.5,934.5,1080,1920,21,29,0,0.6424479166666667,0.8652777777777778,0.015104166666666667,0.019444444444444445
/home/dexter/Desktop/blackbuck/LEK_ANNOTATION/still_images/frame16.jpg,1254,913,1275,929,1264.5,921.0,1080,1920,16,21,0,0.65859375,0.8527777777777777,0.0109375,0.014814814814814815
/home/dexter/Desktop/blackbuck/LEK_ANNOTATION/still_images/frame16.jpg,1266,888,1288,906,1277.0,897.0,1080,1920,18,22,0,0.6651041666666667,0.8305555555555556,0.011458333333333333,0.016666666666666666
/home/dexter/Desktop/blackbuck/LEK_ANNOTATION/still_images/frame16.jpg,1331,796,1354,819,1342.5,807.5,1080,1920,23,23,0,0.69921875,0.7476851851851852,0.011979166666666667,0.021296296296296296
/home/dexter/Desktop/blackbuck/LEK_ANNOTATION/still_images/frame16.jpg,1353,772,1376,790,1364.5,781.0,1080,1920,18,23,0,0.7106770833333333,0.7231481481481481,0.011979166666666667,0.016666666666666666
/home/dexter/Desktop/blackbuck/LEK_ANNOTATION/still_images/frame16.jpg,1384,747,1407,771,1395.5,759.0,1080,1920,24,23,0,0.7268229166666667,0.7027777777777777,0.011979166666666667,0.022222222222222223
/home/dexter/Desktop/blackbuck/LEK_ANNOTATION/still_images/frame16.jpg,1432,705,1456,725,1444.0,715.0,1080,1920,20,24,0,0.7520833333333333,0.6620370370370371,0.0125,0.018518518518518517
/home/dexter/Desktop/blackbuck/LEK_ANNOTATION/still_images/frame16.jpg,1537,622,1558,640,1547.5,631.0,1080,1920,18,21,0,0.8059895833333334,0.5842592592592593,0.0109375,0.016666666666666666
/home/dexter/Desktop/blackbuck/LEK_ANNOTATION/still_images/frame16.jpg,1627,553,1651,573,1639.0,563.0,1080,1920,20,24,0,0.8536458333333333,0.5212962962962963,0.0125,0.018518518518518517
/home/dexter/Desktop/blackbuck/LEK_ANNOTATION/still_images/frame16.jpg,1700,510,1723,526,1711.5,518.0,1080,1920,16,23,0,0.89140625,0.47962962962962963,0.011979166666666667,0.014814814814814815
/home/dexter/Desktop/blackbuck/LEK_ANNOTATION/still_images/frame16.jpg,1774,340,1801,355,1787.5,347.5,1080,1920,15,27,0,0.9309895833333334,0.32175925925925924,0.0140625,0.013888888888888888
/home/dexter/Desktop/blackbuck/LEK_ANNOTATION/still_images/frame16.jpg,1810,398,1840,417,1825.0,407.5,1080,1920,19,30,0,0.9505208333333334,0.3773148148148148,0.015625,0.017592592592592594
/home/dexter/Desktop/blackbuck/LEK_ANNOTATION/still_images/frame16.jpg,1823,308,1844,332,1833.5,320.0,1080,1920,24,21,0,0.9549479166666667,0.2962962962962963,0.0109375,0.022222222222222223
/home/dexter/Desktop/blackbuck/LEK_ANNOTATION/still_images/frame16.jpg,1872,270,1896,297,1884.0,283.5,1080,1920,27,24,0,0.98125,0.2625,0.0125,0.025
/home/dexter/Desktop/blackbuck/LEK_ANNOTATION/still_images/frame378.jpg,584,613,602,635,593.0,624.0,1080,1920,22,18,0,0.30885416666666665,0.5777777777777777,0.009375,0.020370370370370372
/home/dexter/Desktop/blackbuck/LEK_ANNOTATION/still_images/frame378.jpg,621,571,639,590,630.0,580.5,1080,1920,19,18,0,0.328125,0.5375,0.009375,0.017592592592592594
/home/dexter/Desktop/blackbuck/LEK_ANNOTATION/still_images/frame378.jpg,661,552,689,565,675.0,558.5,1080,1920,13,28,0,0.3515625,0.5171296296296296,0.014583333333333334,0.012037037037037037
/home/dexter/Desktop/blackbuck/LEK_ANNOTATION/still_images/frame378.jpg,794,508,809,528,801.5,518.0,1080,1920,20,15,0,0.41744791666666664,0.47962962962962963,0.0078125,0.018518518518518517
/home/dexter/Desktop/blackbuck/LEK_ANNOTATION/still_images/frame378.jpg,800,409,823,427,811.5,418.0,1080,1920,18,23,0,0.42265625,0.387037037037037,0.011979166666666667,0.016666666666666666
/home/dexter/Desktop/blackbuck/LEK_ANNOTATION/still_images/frame378.jpg,851,420,877,433,864.0,426.5,1080,1920,13,26,0,0.45,0.39490740740740743,0.013541666666666667,0.012037037037037037
/home/dexter/Desktop/blackbuck/LEK_ANNOTATION/still_images/frame378.jpg,860,357,878,378,869.0,367.5,1080,1920,21,18,0,0.45260416666666664,0.3402777777777778,0.009375,0.019444444444444445
/home/dexter/Desktop/blackbuck/LEK_ANNOTATION/still_images/frame378.jpg,954,287,981,307,967.5,297.0,1080,1920,20,27,0,0.50390625,0.275,0.0140625,0.018518518518518517
/home/dexter/Desktop/blackbuck/LEK_ANNOTATION/still_images/frame378.jpg,1042,254,1065,271,1053.5,262.5,1080,1920,17,23,0,0.5486979166666667,0.24305555555555555,0.011979166666666667,0.01574074074074074
/home/dexter/Desktop/blackbuck/LEK_ANNOTATION/still_images/frame378.jpg,616,1011,638,1032,627.0,1021.5,1080,1920,21,22,0,0.3265625,0.9458333333333333,0.011458333333333333,0.019444444444444445
/home/dexter/Desktop/blackbuck/LEK_ANNOTATION/still_images/frame378.jpg,858,969,874,1000,866.0,984.5,1080,1920,31,16,0,0.4510416666666667,0.9115740740740741,0.008333333333333333,0.028703703703703703
/home/dexter/Desktop/blackbuck/LEK_ANNOTATION/still_images/frame378.jpg,988,714,1016,725,1002.0,719.5,1080,1920,11,28,0,0.521875,0.6662037037037037,0.014583333333333334,0.010185185185185186
/home/dexter/Desktop/blackbuck/LEK_ANNOTATION/still_images/frame378.jpg,1107,1058,1127,1077,1117.0,1067.5,1080,1920,19,20,0,0.5817708333333333,0.9884259259259259,0.010416666666666666,0.017592592592592594
/home/dexter/Desktop/blackbuck/LEK_ANNOTATION/still_images/frame378.jpg,1139,1038,1155,1063,1147.0,1050.5,1080,1920,25,16,0,0.5973958333333333,0.9726851851851852,0.008333333333333333,0.023148148148148147
/home/dexter/Desktop/blackbuck/LEK_ANNOTATION/still_images/frame378.jpg,1162,1011,1184,1027,1173.0,1019.0,1080,1920,16,22,0,0.6109375,0.9435185185185185,0.011458333333333333,0.014814814814814815
/home/dexter/Desktop/blackbuck/LEK_ANNOTATION/still_images/frame378.jpg,1205,1014,1223,1038,1214.0,1026.0,1080,1920,24,18,0,0.6322916666666667,0.95,0.009375,0.022222222222222223
/home/dexter/Desktop/blackbuck/LEK_ANNOTATION/still_images/frame378.jpg,1185,979,1198,998,1191.5,988.5,1080,1920,19,13,0,0.6205729166666667,0.9152777777777777,0.0067708333333333336,0.017592592592592594
/home/dexter/Desktop/blackbuck/LEK_ANNOTATION/still_images/frame378.jpg,1209,937,1229,965,1219.0,951.0,1080,1920,28,20,0,0.6348958333333333,0.8805555555555555,0.010416666666666666,0.025925925925925925
/home/dexter/Desktop/blackbuck/LEK_ANNOTATION/still_images/frame378.jpg,1260,894,1282,916,1271.0,905.0,1080,1920,22,22,0,0.6619791666666667,0.8379629629629629,0.011458333333333333,0.020370370370370372
/home/dexter/Desktop/blackbuck/LEK_ANNOTATION/still_images/frame378.jpg,1307,900,1329,922,1318.0,911.0,1080,1920,22,22,0,0.6864583333333333,0.8435185185185186,0.011458333333333333,0.020370370370370372
/home/dexter/Desktop/blackbuck/LEK_ANNOTATION/still_images/frame378.jpg,1288,851,1307,876,1297.5,863.5,1080,1920,25,19,0,0.67578125,0.799537037037037,0.009895833333333333,0.023148148148148147
/home/dexter/Desktop/blackbuck/LEK_ANNOTATION/still_images/frame378.jpg,1322,850,1345,874,1333.5,862.0,1080,1920,24,23,0,0.69453125,0.7981481481481482,0.011979166666666667,0.022222222222222223
/home/dexter/Desktop/blackbuck/LEK_ANNOTATION/still_images/frame378.jpg,1313,814,1337,835,1325.0,824.5,1080,1920,21,24,0,0.6901041666666666,0.763425925925926,0.0125,0.019444444444444445
/home/dexter/Desktop/blackbuck/LEK_ANNOTATION/still_images/frame378.jpg,1415,714,1438,736,1426.5,725.0,1080,1920,22,23,0,0.74296875,0.6712962962962963,0.011979166666666667,0.020370370370370372
/home/dexter/Desktop/blackbuck/LEK_ANNOTATION/still_images/frame378.jpg,1443,702,1469,715,1456.0,708.5,1080,1920,13,26,0,0.7583333333333333,0.6560185185185186,0.013541666666666667,0.012037037037037037
/home/dexter/Desktop/blackbuck/LEK_ANNOTATION/still_images/frame378.jpg,1469,683,1494,699,1481.5,691.0,1080,1920,16,25,0,0.7716145833333333,0.6398148148148148,0.013020833333333334,0.014814814814814815
/home/dexter/Desktop/blackbuck/LEK_ANNOTATION/still_images/frame378.jpg,1508,631,1536,647,1522.0,639.0,1080,1920,16,28,0,0.7927083333333333,0.5916666666666667,0.014583333333333334,0.014814814814814815
/home/dexter/Desktop/blackbuck/LEK_ANNOTATION/still_images/frame378.jpg,1616,560,1644,575,1630.0,567.5,1080,1920,15,28,0,0.8489583333333334,0.5254629629629629,0.014583333333333334,0.013888888888888888
/home/dexter/Desktop/blackbuck/LEK_ANNOTATION/still_images/frame378.jpg,1704,507,1738,521,1721.0,514.0,1080,1920,14,34,0,0.8963541666666667,0.4759259259259259,0.017708333333333333,0.012962962962962963
/home/dexter/Desktop/blackbuck/LEK_ANNOTATION/still_images/frame378.jpg,1854,267,1873,296,1863.5,281.5,1080,1920,29,19,0,0.9705729166666667,0.26064814814814813,0.009895833333333333,0.026851851851851852
/home/dexter/Desktop/blackbuck/LEK_ANNOTATION/still_images/frame378.jpg,1896,237,1918,257,1907.0,247.0,1080,1920,20,22,0,0.9932291666666667,0.22870370370370371,0.011458333333333333,0.018518518518518517
/home/dexter/Desktop/blackbuck/LEK_ANNOTATION/still_images/frame522.jpg,651,992,679,1005,665.0,998.5,1080,1920,13,28,0,0.3463541666666667,0.924537037037037,0.014583333333333334,0.012037037037037037
/home/dexter/Desktop/blackbuck/LEK_ANNOTATION/still_images/frame522.jpg,607,584,632,599,619.5,591.5,1080,1920,15,25,0,0.32265625,0.5476851851851852,0.013020833333333334,0.013888888888888888
/home/dexter/Desktop/blackbuck/LEK_ANNOTATION/still_images/frame522.jpg,861,968,880,990,870.5,979.0,1080,1920,22,19,0,0.45338541666666665,0.9064814814814814,0.009895833333333333,0.020370370370370372
/home/dexter/Desktop/blackbuck/LEK_ANNOTATION/still_images/frame522.jpg,654,543,676,560,665.0,551.5,1080,1920,17,22,0,0.3463541666666667,0.5106481481481482,0.011458333333333333,0.01574074074074074
/home/dexter/Desktop/blackbuck/LEK_ANNOTATION/still_images/frame522.jpg,704,543,729,556,716.5,549.5,1080,1920,13,25,0,0.3731770833333333,0.5087962962962963,0.013020833333333334,0.012037037037037037
/home/dexter/Desktop/blackbuck/LEK_ANNOTATION/still_images/frame522.jpg,822,483,840,501,831.0,492.0,1080,1920,18,18,0,0.4328125,0.45555555555555555,0.009375,0.016666666666666666
/home/dexter/Desktop/blackbuck/LEK_ANNOTATION/still_images/frame522.jpg,833,378,857,396,845.0,387.0,1080,1920,18,24,0,0.4401041666666667,0.35833333333333334,0.0125,0.016666666666666666
/home/dexter/Desktop/blackbuck/LEK_ANNOTATION/still_images/frame522.jpg,887,400,915,415,901.0,407.5,1080,1920,15,28,0,0.46927083333333336,0.3773148148148148,0.014583333333333334,0.013888888888888888
/home/dexter/Desktop/blackbuck/LEK_ANNOTATION/still_images/frame522.jpg,896,335,914,349,905.0,342.0,1080,1920,14,18,0,0.4713541666666667,0.31666666666666665,0.009375,0.012962962962962963
/home/dexter/Desktop/blackbuck/LEK_ANNOTATION/still_images/frame522.jpg,1004,267,1023,283,1013.5,275.0,1080,1920,16,19,0,0.5278645833333333,0.25462962962962965,0.009895833333333333,0.014814814814814815
/home/dexter/Desktop/blackbuck/LEK_ANNOTATION/still_images/frame522.jpg,1083,247,1107,259,1095.0,253.0,1080,1920,12,24,0,0.5703125,0.23425925925925925,0.0125,0.011111111111111112
/home/dexter/Desktop/blackbuck/LEK_ANNOTATION/still_images/frame522.jpg,1025,684,1049,701,1037.0,692.5,1080,1920,17,24,0,0.5401041666666667,0.6412037037037037,0.0125,0.01574074074074074
/home/dexter/Desktop/blackbuck/LEK_ANNOTATION/still_images/frame522.jpg,1112,1068,1133,1078,1122.5,1073.0,1080,1920,10,21,0,0.5846354166666666,0.9935185185185185,0.0109375,0.009259259259259259
/home/dexter/Desktop/blackbuck/LEK_ANNOTATION/still_images/frame522.jpg,1128,1051,1144,1070,1136.0,1060.5,1080,1920,19,16,0,0.5916666666666667,0.9819444444444444,0.008333333333333333,0.017592592592592594
/home/dexter/Desktop/blackbuck/LEK_ANNOTATION/still_images/frame522.jpg,1142,1029,1162,1055,1152.0,1042.0,1080,1920,26,20,0,0.6,0.9648148148148148,0.010416666666666666,0.024074074074074074
/home/dexter/Desktop/blackbuck/LEK_ANNOTATION/still_images/frame522.jpg,1165,1005,1188,1029,1176.5,1017.0,1080,1920,24,23,0,0.6127604166666667,0.9416666666666667,0.011979166666666667,0.022222222222222223
/home/dexter/Desktop/blackbuck/LEK_ANNOTATION/still_images/frame522.jpg,1199,970,1217,992,1208.0,981.0,1080,1920,22,18,0,0.6291666666666667,0.9083333333333333,0.009375,0.020370370370370372
/home/dexter/Desktop/blackbuck/LEK_ANNOTATION/still_images/frame522.jpg,1233,987,1252,1008,1242.5,997.5,1080,1920,21,19,0,0.6471354166666666,0.9236111111111112,0.009895833333333333,0.019444444444444445
/home/dexter/Desktop/blackbuck/LEK_ANNOTATION/still_images/frame522.jpg,1216,946,1233,964,1224.5,955.0,1080,1920,18,17,0,0.6377604166666667,0.8842592592592593,0.008854166666666666,0.016666666666666666
/home/dexter/Desktop/blackbuck/LEK_ANNOTATION/still_images/frame522.jpg,1245,912,1266,929,1255.5,920.5,1080,1920,17,21,0,0.65390625,0.8523148148148149,0.0109375,0.01574074074074074
/home/dexter/Desktop/blackbuck/LEK_ANNOTATION/still_images/frame522.jpg,1345,869,1366,893,1355.5,881.0,1080,1920,24,21,0,0.7059895833333333,0.8157407407407408,0.0109375,0.022222222222222223
/home/dexter/Desktop/blackbuck/LEK_ANNOTATION/still_images/frame522.jpg,1313,818,1333,840,1323.0,829.0,1080,1920,22,20,0,0.6890625,0.7675925925925926,0.010416666666666666,0.020370370370370372
/home/dexter/Desktop/blackbuck/LEK_ANNOTATION/still_images/frame522.jpg,1357,828,1376,852,1366.5,840.0,1080,1920,24,19,0,0.71171875,0.7777777777777778,0.009895833333333333,0.022222222222222223
/home/dexter/Desktop/blackbuck/LEK_ANNOTATION/still_images/frame522.jpg,1349,791,1368,814,1358.5,802.5,1080,1920,23,19,0,0.7075520833333333,0.7430555555555556,0.009895833333333333,0.021296296296296296
/home/dexter/Desktop/blackbuck/LEK_ANNOTATION/still_images/frame522.jpg,1452,691,1478,707,1465.0,699.0,1080,1920,16,26,0,0.7630208333333334,0.6472222222222223,0.013541666666666667,0.014814814814814815
/home/dexter/Desktop/blackbuck/LEK_ANNOTATION/still_images/frame522.jpg,1485,674,1504,688,1494.5,681.0,1080,1920,14,19,0,0.7783854166666667,0.6305555555555555,0.009895833333333333,0.012962962962962963
/home/dexter/Desktop/blackbuck/LEK_ANNOTATION/still_images/frame522.jpg,1500,645,1522,666,1511.0,655.5,1080,1920,21,22,0,0.7869791666666667,0.6069444444444444,0.011458333333333333,0.019444444444444445
/home/dexter/Desktop/blackbuck/LEK_ANNOTATION/still_images/frame522.jpg,1547,607,1574,622,1560.5,614.5,1080,1920,15,27,0,0.8127604166666667,0.5689814814814815,0.0140625,0.013888888888888888
/home/dexter/Desktop/blackbuck/LEK_ANNOTATION/still_images/frame522.jpg,1658,534,1683,552,1670.5,543.0,1080,1920,18,25,0,0.8700520833333333,0.5027777777777778,0.013020833333333334,0.016666666666666666
/home/dexter/Desktop/blackbuck/LEK_ANNOTATION/still_images/frame522.jpg,1784,478,1809,494,1796.5,486.0,1080,1920,16,25,0,0.9356770833333333,0.45,0.013020833333333334,0.014814814814814815
/home/dexter/Desktop/blackbuck/LEK_ANNOTATION/still_images/frame522.jpg,1886,238,1911,259,1898.5,248.5,1080,1920,21,25,0,0.9888020833333333,0.2300925925925926,0.013020833333333334,0.019444444444444445
/home/dexter/Desktop/blackbuck/LEK_ANNOTATION/still_images/frame522.jpg,1748,491,1769,509,1758.5,500.0,1080,1920,18,21,0,0.9158854166666667,0.46296296296296297,0.0109375,0.016666666666666666
/home/dexter/Desktop/blackbuck/LEK_ANNOTATION/still_images/frame468.jpg,600,597,619,612,609.5,604.5,1080,1920,15,19,0,0.31744791666666666,0.5597222222222222,0.009895833333333333,0.013888888888888888
/home/dexter/Desktop/blackbuck/LEK_ANNOTATION/still_images/frame468.jpg,642,555,664,571,653.0,563.0,1080,1920,16,22,0,0.34010416666666665,0.5212962962962963,0.011458333333333333,0.014814814814814815
/home/dexter/Desktop/blackbuck/LEK_ANNOTATION/still_images/frame468.jpg,687,545,713,560,700.0,552.5,1080,1920,15,26,0,0.3645833333333333,0.5115740740740741,0.013541666666666667,0.013888888888888888
/home/dexter/Desktop/blackbuck/LEK_ANNOTATION/still_images/frame468.jpg,809,496,828,513,818.5,504.5,1080,1920,17,19,0,0.42630208333333336,0.4671296296296296,0.009895833333333333,0.01574074074074074
/home/dexter/Desktop/blackbuck/LEK_ANNOTATION/still_images/frame468.jpg,640,998,660,1014,650.0,1006.0,1080,1920,16,20,0,0.3385416666666667,0.9314814814814815,0.010416666666666666,0.014814814814814815
/home/dexter/Desktop/blackbuck/LEK_ANNOTATION/still_images/frame468.jpg,862,965,875,994,868.5,979.5,1080,1920,29,13,0,0.45234375,0.9069444444444444,0.0067708333333333336,0.026851851851851852
/home/dexter/Desktop/blackbuck/LEK_ANNOTATION/still_images/frame468.jpg,822,387,842,405,832.0,396.0,1080,1920,18,20,0,0.43333333333333335,0.36666666666666664,0.010416666666666666,0.016666666666666666
/home/dexter/Desktop/blackbuck/LEK_ANNOTATION/still_images/frame468.jpg,876,409,900,424,888.0,416.5,1080,1920,15,24,0,0.4625,0.38564814814814813,0.0125,0.013888888888888888
/home/dexter/Desktop/blackbuck/LEK_ANNOTATION/still_images/frame468.jpg,879,340,898,358,888.5,349.0,1080,1920,18,19,0,0.4627604166666667,0.32314814814814813,0.009895833333333333,0.016666666666666666
/home/dexter/Desktop/blackbuck/LEK_ANNOTATION/still_images/frame468.jpg,1010,691,1030,709,1020.0,700.0,1080,1920,18,20,0,0.53125,0.6481481481481481,0.010416666666666666,0.016666666666666666
/home/dexter/Desktop/blackbuck/LEK_ANNOTATION/still_images/frame468.jpg,982,280,1008,292,995.0,286.0,1080,1920,12,26,0,0.5182291666666666,0.26481481481481484,0.013541666666666667,0.011111111111111112
/home/dexter/Desktop/blackbuck/LEK_ANNOTATION/still_images/frame468.jpg,1067,250,1093,262,1080.0,256.0,1080,1920,12,26,0,0.5625,0.23703703703703705,0.013541666666666667,0.011111111111111112
/home/dexter/Desktop/blackbuck/LEK_ANNOTATION/still_images/frame468.jpg,1121,1065,1134,1078,1127.5,1071.5,1080,1920,13,13,0,0.5872395833333334,0.9921296296296296,0.0067708333333333336,0.012037037037037037
/home/dexter/Desktop/blackbuck/LEK_ANNOTATION/still_images/frame468.jpg,1125,1046,1149,1063,1137.0,1054.5,1080,1920,17,24,0,0.5921875,0.9763888888888889,0.0125,0.01574074074074074
/home/dexter/Desktop/blackbuck/LEK_ANNOTATION/still_images/frame468.jpg,1154,1014,1173,1038,1163.5,1026.0,1080,1920,24,19,0,0.6059895833333333,0.95,0.009895833333333333,0.022222222222222223
/home/dexter/Desktop/blackbuck/LEK_ANNOTATION/still_images/frame468.jpg,1185,984,1207,1001,1196.0,992.5,1080,1920,17,22,0,0.6229166666666667,0.9189814814814815,0.011458333333333333,0.01574074074074074
/home/dexter/Desktop/blackbuck/LEK_ANNOTATION/still_images/frame468.jpg,1223,999,1239,1018,1231.0,1008.5,1080,1920,19,16,0,0.6411458333333333,0.9337962962962963,0.008333333333333333,0.017592592592592594
/home/dexter/Desktop/blackbuck/LEK_ANNOTATION/still_images/frame468.jpg,1202,963,1219,979,1210.5,971.0,1080,1920,16,17,0,0.63046875,0.899074074074074,0.008854166666666666,0.014814814814814815
/home/dexter/Desktop/blackbuck/LEK_ANNOTATION/still_images/frame468.jpg,1232,921,1254,941,1243.0,931.0,1080,1920,20,22,0,0.6473958333333333,0.862037037037037,0.011458333333333333,0.018518518518518517
/home/dexter/Desktop/blackbuck/LEK_ANNOTATION/still_images/frame468.jpg,1333,883,1353,900,1343.0,891.5,1080,1920,17,20,0,0.6994791666666667,0.825462962962963,0.010416666666666666,0.01574074074074074
/home/dexter/Desktop/blackbuck/LEK_ANNOTATION/still_images/frame468.jpg,1308,831,1322,854,1315.0,842.5,1080,1920,23,14,0,0.6848958333333334,0.7800925925925926,0.007291666666666667,0.021296296296296296
/home/dexter/Desktop/blackbuck/LEK_ANNOTATION/still_images/frame468.jpg,1342,840,1365,858,1353.5,849.0,1080,1920,18,23,0,0.7049479166666667,0.7861111111111111,0.011979166666666667,0.016666666666666666
/home/dexter/Desktop/blackbuck/LEK_ANNOTATION/still_images/frame468.jpg,1338,800,1357,822,1347.5,811.0,1080,1920,22,19,0,0.7018229166666666,0.7509259259259259,0.009895833333333333,0.020370370370370372
/home/dexter/Desktop/blackbuck/LEK_ANNOTATION/still_images/frame468.jpg,1438,702,1465,718,1451.5,710.0,1080,1920,16,27,0,0.7559895833333333,0.6574074074074074,0.0140625,0.014814814814814815
/home/dexter/Desktop/blackbuck/LEK_ANNOTATION/still_images/frame468.jpg,1468,682,1492,698,1480.0,690.0,1080,1920,16,24,0,0.7708333333333334,0.6388888888888888,0.0125,0.014814814814814815
/home/dexter/Desktop/blackbuck/LEK_ANNOTATION/still_images/frame468.jpg,1492,657,1514,682,1503.0,669.5,1080,1920,25,22,0,0.7828125,0.6199074074074075,0.011458333333333333,0.023148148148148147
/home/dexter/Desktop/blackbuck/LEK_ANNOTATION/still_images/frame468.jpg,1529,614,1559,626,1544.0,620.0,1080,1920,12,30,0,0.8041666666666667,0.5740740740740741,0.015625,0.011111111111111112
/home/dexter/Desktop/blackbuck/LEK_ANNOTATION/still_images/frame468.jpg,1641,537,1667,558,1654.0,547.5,1080,1920,21,26,0,0.8614583333333333,0.5069444444444444,0.013541666666666667,0.019444444444444445
/home/dexter/Desktop/blackbuck/LEK_ANNOTATION/still_images/frame468.jpg,1731,499,1761,512,1746.0,505.5,1080,1920,13,30,0,0.909375,0.46805555555555556,0.015625,0.012037037037037037
/home/dexter/Desktop/blackbuck/LEK_ANNOTATION/still_images/frame468.jpg,1760,482,1792,497,1776.0,489.5,1080,1920,15,32,0,0.925,0.4532407407407407,0.016666666666666666,0.013888888888888888
/home/dexter/Desktop/blackbuck/LEK_ANNOTATION/still_images/frame468.jpg,1878,247,1897,271,1887.5,259.0,1080,1920,24,19,0,0.9830729166666666,0.23981481481481481,0.009895833333333333,0.022222222222222223
/home/dexter/Desktop/blackbuck/LEK_ANNOTATION/still_images/frame90.jpg,526,681,543,694,534.5,687.5,1080,1920,13,17,0,0.27838541666666666,0.6365740740740741,0.008854166666666666,0.012037037037037037
/home/dexter/Desktop/blackbuck/LEK_ANNOTATION/still_images/frame90.jpg,563,634,582,651,572.5,642.5,1080,1920,17,19,0,0.2981770833333333,0.5949074074074074,0.009895833333333333,0.01574074074074074
/home/dexter/Desktop/blackbuck/LEK_ANNOTATION/still_images/frame90.jpg,598,595,616,612,607.0,603.5,1080,1920,17,18,0,0.31614583333333335,0.5587962962962963,0.009375,0.01574074074074074
/home/dexter/Desktop/blackbuck/LEK_ANNOTATION/still_images/frame90.jpg,738,558,755,573,746.5,565.5,1080,1920,15,17,0,0.3888020833333333,0.5236111111111111,0.008854166666666666,0.013888888888888888
/home/dexter/Desktop/blackbuck/LEK_ANNOTATION/still_images/frame90.jpg,736,474,757,493,746.5,483.5,1080,1920,19,21,0,0.3888020833333333,0.4476851851851852,0.0109375,0.017592592592592594
/home/dexter/Desktop/blackbuck/LEK_ANNOTATION/still_images/frame90.jpg,771,447,791,462,781.0,454.5,1080,1920,15,20,0,0.40677083333333336,0.42083333333333334,0.010416666666666666,0.013888888888888888
/home/dexter/Desktop/blackbuck/LEK_ANNOTATION/still_images/frame90.jpg,793,415,814,433,803.5,424.0,1080,1920,18,21,0,0.41848958333333336,0.3925925925925926,0.0109375,0.016666666666666666
/home/dexter/Desktop/blackbuck/LEK_ANNOTATION/still_images/frame90.jpg,895,333,917,355,906.0,344.0,1080,1920,22,22,0,0.471875,0.31851851851851853,0.011458333333333333,0.020370370370370372
/home/dexter/Desktop/blackbuck/LEK_ANNOTATION/still_images/frame90.jpg,963,269,986,287,974.5,278.0,1080,1920,18,23,0,0.5075520833333333,0.2574074074074074,0.011979166666666667,0.016666666666666666
/home/dexter/Desktop/blackbuck/LEK_ANNOTATION/still_images/frame90.jpg,915,746,931,759,923.0,752.5,1080,1920,13,16,0,0.48072916666666665,0.6967592592592593,0.008333333333333333,0.012037037037037037
/home/dexter/Desktop/blackbuck/LEK_ANNOTATION/still_images/frame90.jpg,607,1020,625,1038,616.0,1029.0,1080,1920,18,18,0,0.32083333333333336,0.9527777777777777,0.009375,0.016666666666666666
/home/dexter/Desktop/blackbuck/LEK_ANNOTATION/still_images/frame90.jpg,852,972,865,998,858.5,985.0,1080,1920,26,13,0,0.4471354166666667,0.9120370370370371,0.0067708333333333336,0.024074074074074074
/home/dexter/Desktop/blackbuck/LEK_ANNOTATION/still_images/frame90.jpg,1123,1042,1141,1061,1132.0,1051.5,1080,1920,19,18,0,0.5895833333333333,0.9736111111111111,0.009375,0.017592592592592594
/home/dexter/Desktop/blackbuck/LEK_ANNOTATION/still_images/frame90.jpg,1152,1015,1171,1033,1161.5,1024.0,1080,1920,18,19,0,0.6049479166666667,0.9481481481481482,0.009895833333333333,0.016666666666666666
/home/dexter/Desktop/blackbuck/LEK_ANNOTATION/still_images/frame90.jpg,1181,1061,1201,1080,1191.0,1070.5,1080,1920,19,20,0,0.6203125,0.9912037037037037,0.010416666666666666,0.017592592592592594
/home/dexter/Desktop/blackbuck/LEK_ANNOTATION/still_images/frame90.jpg,1243,952,1268,976,1255.5,964.0,1080,1920,24,25,0,0.65390625,0.8925925925925926,0.013020833333333334,0.022222222222222223
/home/dexter/Desktop/blackbuck/LEK_ANNOTATION/still_images/frame90.jpg,1241,914,1260,933,1250.5,923.5,1080,1920,19,19,0,0.6513020833333333,0.8550925925925926,0.009895833333333333,0.017592592592592594
/home/dexter/Desktop/blackbuck/LEK_ANNOTATION/still_images/frame90.jpg,1268,903,1296,917,1282.0,910.0,1080,1920,14,28,0,0.6677083333333333,0.8425925925925926,0.014583333333333334,0.012962962962962963
/home/dexter/Desktop/blackbuck/LEK_ANNOTATION/still_images/frame90.jpg,1277,879,1300,894,1288.5,886.5,1080,1920,15,23,0,0.67109375,0.8208333333333333,0.011979166666666667,0.013888888888888888
/home/dexter/Desktop/blackbuck/LEK_ANNOTATION/still_images/frame90.jpg,1346,776,1370,800,1358.0,788.0,1080,1920,24,24,0,0.7072916666666667,0.7296296296296296,0.0125,0.022222222222222223
/home/dexter/Desktop/blackbuck/LEK_ANNOTATION/still_images/frame90.jpg,1374,760,1393,776,1383.5,768.0,1080,1920,16,19,0,0.7205729166666667,0.7111111111111111,0.009895833333333333,0.014814814814814815
/home/dexter/Desktop/blackbuck/LEK_ANNOTATION/still_images/frame90.jpg,1397,729,1424,751,1410.5,740.0,1080,1920,22,27,0,0.7346354166666667,0.6851851851851852,0.0140625,0.020370370370370372
/home/dexter/Desktop/blackbuck/LEK_ANNOTATION/still_images/frame90.jpg,1449,694,1488,701,1468.5,697.5,1080,1920,7,39,0,0.76484375,0.6458333333333334,0.0203125,0.006481481481481481
/home/dexter/Desktop/blackbuck/LEK_ANNOTATION/still_images/frame90.jpg,1549,603,1574,623,1561.5,613.0,1080,1920,20,25,0,0.81328125,0.5675925925925925,0.013020833333333334,0.018518518518518517
/home/dexter/Desktop/blackbuck/LEK_ANNOTATION/still_images/frame90.jpg,1638,542,1666,558,1652.0,550.0,1080,1920,16,28,0,0.8604166666666667,0.5092592592592593,0.014583333333333334,0.014814814814814815
/home/dexter/Desktop/blackbuck/LEK_ANNOTATION/still_images/frame90.jpg,1713,497,1741,516,1727.0,506.5,1080,1920,19,28,0,0.8994791666666667,0.4689814814814815,0.014583333333333334,0.017592592592592594
/home/dexter/Desktop/blackbuck/LEK_ANNOTATION/still_images/frame90.jpg,1824,391,1856,405,1840.0,398.0,1080,1920,14,32,0,0.9583333333333334,0.3685185185185185,0.016666666666666666,0.012962962962962963
/home/dexter/Desktop/blackbuck/LEK_ANNOTATION/still_images/frame90.jpg,1797,335,1819,346,1808.0,340.5,1080,1920,11,22,0,0.9416666666666667,0.31527777777777777,0.011458333333333333,0.010185185185185186
/home/dexter/Desktop/blackbuck/LEK_ANNOTATION/still_images/frame90.jpg,1832,291,1856,315,1844.0,303.0,1080,1920,24,24,0,0.9604166666666667,0.28055555555555556,0.0125,0.022222222222222223
/home/dexter/Desktop/blackbuck/LEK_ANNOTATION/still_images/frame90.jpg,1880,258,1907,276,1893.5,267.0,1080,1920,18,27,0,0.9861979166666667,0.24722222222222223,0.0140625,0.016666666666666666
/home/dexter/Desktop/blackbuck/LEK_ANNOTATION/still_images/frame590.jpg,58,689,79,712,68.5,700.5,1080,1920,23,21,0,0.03567708333333333,0.6486111111111111,0.0109375,0.021296296296296296
/home/dexter/Desktop/blackbuck/LEK_ANNOTATION/still_images/frame590.jpg,624,571,639,589,631.5,580.0,1080,1920,18,15,0,0.32890625,0.5370370370370371,0.0078125,0.016666666666666666
/home/dexter/Desktop/blackbuck/LEK_ANNOTATION/still_images/frame590.jpg,670,533,692,547,681.0,540.0,1080,1920,14,22,0,0.3546875,0.5,0.011458333333333333,0.012962962962962963
/home/dexter/Desktop/blackbuck/LEK_ANNOTATION/still_images/frame590.jpg,726,537,747,550,736.5,543.5,1080,1920,13,21,0,0.38359375,0.5032407407407408,0.0109375,0.012037037037037037
/home/dexter/Desktop/blackbuck/LEK_ANNOTATION/still_images/frame590.jpg,673,985,703,997,688.0,991.0,1080,1920,12,30,0,0.35833333333333334,0.9175925925925926,0.015625,0.011111111111111112
/home/dexter/Desktop/blackbuck/LEK_ANNOTATION/still_images/frame590.jpg,866,966,880,991,873.0,978.5,1080,1920,25,14,0,0.4546875,0.9060185185185186,0.007291666666666667,0.023148148148148147
/home/dexter/Desktop/blackbuck/LEK_ANNOTATION/still_images/frame590.jpg,1040,667,1062,689,1051.0,678.0,1080,1920,22,22,0,0.5473958333333333,0.6277777777777778,0.011458333333333333,0.020370370370370372
/home/dexter/Desktop/blackbuck/LEK_ANNOTATION/still_images/frame590.jpg,832,468,853,493,842.5,480.5,1080,1920,25,21,0,0.4388020833333333,0.4449074074074074,0.0109375,0.023148148148148147
/home/dexter/Desktop/blackbuck/LEK_ANNOTATION/still_images/frame590.jpg,854,362,877,384,865.5,373.0,1080,1920,22,23,0,0.45078125,0.3453703703703704,0.011979166666666667,0.020370370370370372
/home/dexter/Desktop/blackbuck/LEK_ANNOTATION/still_images/frame590.jpg,899,391,918,408,908.5,399.5,1080,1920,17,19,0,0.47317708333333336,0.3699074074074074,0.009895833333333333,0.01574074074074074
/home/dexter/Desktop/blackbuck/LEK_ANNOTATION/still_images/frame590.jpg,910,320,934,336,922.0,328.0,1080,1920,16,24,0,0.48020833333333335,0.3037037037037037,0.0125,0.014814814814814815
/home/dexter/Desktop/blackbuck/LEK_ANNOTATION/still_images/frame590.jpg,1020,253,1043,275,1031.5,264.0,1080,1920,22,23,0,0.5372395833333333,0.24444444444444444,0.011979166666666667,0.020370370370370372
/home/dexter/Desktop/blackbuck/LEK_ANNOTATION/still_images/frame590.jpg,1101,242,1127,260,1114.0,251.0,1080,1920,18,26,0,0.5802083333333333,0.2324074074074074,0.013541666666666667,0.016666666666666666
/home/dexter/Desktop/blackbuck/LEK_ANNOTATION/still_images/frame590.jpg,1125,1051,1143,1068,1134.0,1059.5,1080,1920,17,18,0,0.590625,0.9810185185185185,0.009375,0.01574074074074074
/home/dexter/Desktop/blackbuck/LEK_ANNOTATION/still_images/frame590.jpg,1139,1036,1165,1057,1152.0,1046.5,1080,1920,21,26,0,0.6,0.9689814814814814,0.013541666666666667,0.019444444444444445
/home/dexter/Desktop/blackbuck/LEK_ANNOTATION/still_images/frame590.jpg,1156,1017,1175,1039,1165.5,1028.0,1080,1920,22,19,0,0.60703125,0.9518518518518518,0.009895833333333333,0.020370370370370372
/home/dexter/Desktop/blackbuck/LEK_ANNOTATION/still_images/frame590.jpg,1179,988,1202,1012,1190.5,1000.0,1080,1920,24,23,0,0.6200520833333333,0.9259259259259259,0.011979166666666667,0.022222222222222223
/home/dexter/Desktop/blackbuck/LEK_ANNOTATION/still_images/frame590.jpg,1209,949,1232,973,1220.5,961.0,1080,1920,24,23,0,0.6356770833333333,0.8898148148148148,0.011979166666666667,0.022222222222222223
/home/dexter/Desktop/blackbuck/LEK_ANNOTATION/still_images/frame590.jpg,1225,932,1247,949,1236.0,940.5,1080,1920,17,22,0,0.64375,0.8708333333333333,0.011458333333333333,0.01574074074074074
/home/dexter/Desktop/blackbuck/LEK_ANNOTATION/still_images/frame590.jpg,1243,982,1268,998,1255.5,990.0,1080,1920,16,25,0,0.65390625,0.9166666666666666,0.013020833333333334,0.014814814814814815
/home/dexter/Desktop/blackbuck/LEK_ANNOTATION/still_images/frame590.jpg,1255,892,1285,916,1270.0,904.0,1080,1920,24,30,0,0.6614583333333334,0.837037037037037,0.015625,0.022222222222222223
/home/dexter/Desktop/blackbuck/LEK_ANNOTATION/still_images/frame590.jpg,1306,841,1323,867,1314.5,854.0,1080,1920,26,17,0,0.6846354166666667,0.7907407407407407,0.008854166666666666,0.024074074074074074
/home/dexter/Desktop/blackbuck/LEK_ANNOTATION/still_images/frame590.jpg,1321,810,1348,826,1334.5,818.0,1080,1920,16,27,0,0.6950520833333333,0.7574074074074074,0.0140625,0.014814814814814815
/home/dexter/Desktop/blackbuck/LEK_ANNOTATION/still_images/frame590.jpg,1358,857,1379,877,1368.5,867.0,1080,1920,20,21,0,0.7127604166666667,0.8027777777777778,0.0109375,0.018518518518518517
/home/dexter/Desktop/blackbuck/LEK_ANNOTATION/still_images/frame590.jpg,1370,809,1394,837,1382.0,823.0,1080,1920,28,24,0,0.7197916666666667,0.7620370370370371,0.0125,0.025925925925925925
/home/dexter/Desktop/blackbuck/LEK_ANNOTATION/still_images/frame590.jpg,1358,777,1384,803,1371.0,790.0,1080,1920,26,26,0,0.7140625,0.7314814814814815,0.013541666666666667,0.024074074074074074
/home/dexter/Desktop/blackbuck/LEK_ANNOTATION/still_images/frame590.jpg,1474,675,1500,697,1487.0,686.0,1080,1920,22,26,0,0.7744791666666667,0.6351851851851852,0.013541666666666667,0.020370370370370372
/home/dexter/Desktop/blackbuck/LEK_ANNOTATION/still_images/frame590.jpg,1497,654,1520,673,1508.5,663.5,1080,1920,19,23,0,0.7856770833333333,0.6143518518518518,0.011979166666666667,0.017592592592592594
/home/dexter/Desktop/blackbuck/LEK_ANNOTATION/still_images/frame590.jpg,1515,625,1537,651,1526.0,638.0,1080,1920,26,22,0,0.7947916666666667,0.5907407407407408,0.011458333333333333,0.024074074074074074
/home/dexter/Desktop/blackbuck/LEK_ANNOTATION/still_images/frame590.jpg,1560,596,1595,616,1577.5,606.0,1080,1920,20,35,0,0.8216145833333334,0.5611111111111111,0.018229166666666668,0.018518518518518517
/home/dexter/Desktop/blackbuck/LEK_ANNOTATION/still_images/frame590.jpg,1673,520,1700,539,1686.5,529.5,1080,1920,19,27,0,0.8783854166666667,0.49027777777777776,0.0140625,0.017592592592592594
/home/dexter/Desktop/blackbuck/LEK_ANNOTATION/still_images/frame590.jpg,1759,488,1777,504,1768.0,496.0,1080,1920,16,18,0,0.9208333333333333,0.45925925925925926,0.009375,0.014814814814814815
/home/dexter/Desktop/blackbuck/LEK_ANNOTATION/still_images/frame590.jpg,1800,473,1834,484,1817.0,478.5,1080,1920,11,34,0,0.9463541666666667,0.44305555555555554,0.017708333333333333,0.010185185185185186
/home/dexter/Desktop/blackbuck/LEK_ANNOTATION/still_images/frame260.jpg,552,641,580,658,566.0,649.5,1080,1920,17,28,0,0.2947916666666667,0.6013888888888889,0.014583333333333334,0.01574074074074074
/home/dexter/Desktop/blackbuck/LEK_ANNOTATION/still_images/frame260.jpg,598,595,616,617,607.0,606.0,1080,1920,22,18,0,0.31614583333333335,0.5611111111111111,0.009375,0.020370370370370372
/home/dexter/Desktop/blackbuck/LEK_ANNOTATION/still_images/frame260.jpg,631,562,657,577,644.0,569.5,1080,1920,15,26,0,0.33541666666666664,0.5273148148148148,0.013541666666666667,0.013888888888888888
/home/dexter/Desktop/blackbuck/LEK_ANNOTATION/still_images/frame260.jpg,772,532,794,547,783.0,539.5,1080,1920,15,22,0,0.4078125,0.49953703703703706,0.011458333333333333,0.013888888888888888
/home/dexter/Desktop/blackbuck/LEK_ANNOTATION/still_images/frame260.jpg,776,434,797,455,786.5,444.5,1080,1920,21,21,0,0.40963541666666664,0.4115740740740741,0.0109375,0.019444444444444445
/home/dexter/Desktop/blackbuck/LEK_ANNOTATION/still_images/frame260.jpg,820,436,844,450,832.0,443.0,1080,1920,14,24,0,0.43333333333333335,0.4101851851851852,0.0125,0.012962962962962963
/home/dexter/Desktop/blackbuck/LEK_ANNOTATION/still_images/frame260.jpg,833,381,852,398,842.5,389.5,1080,1920,17,19,0,0.4388020833333333,0.36064814814814816,0.009895833333333333,0.01574074074074074
/home/dexter/Desktop/blackbuck/LEK_ANNOTATION/still_images/frame260.jpg,928,301,949,323,938.5,312.0,1080,1920,22,21,0,0.48880208333333336,0.28888888888888886,0.0109375,0.020370370370370372
/home/dexter/Desktop/blackbuck/LEK_ANNOTATION/still_images/frame260.jpg,1007,264,1032,286,1019.5,275.0,1080,1920,22,25,0,0.5309895833333333,0.25462962962962965,0.013020833333333334,0.020370370370370372
/home/dexter/Desktop/blackbuck/LEK_ANNOTATION/still_images/frame260.jpg,611,1019,632,1037,621.5,1028.0,1080,1920,18,21,0,0.32369791666666664,0.9518518518518518,0.0109375,0.016666666666666666
/home/dexter/Desktop/blackbuck/LEK_ANNOTATION/still_images/frame260.jpg,854,970,871,999,862.5,984.5,1080,1920,29,17,0,0.44921875,0.9115740740740741,0.008854166666666666,0.026851851851851852
/home/dexter/Desktop/blackbuck/LEK_ANNOTATION/still_images/frame260.jpg,958,722,983,741,970.5,731.5,1080,1920,19,25,0,0.50546875,0.6773148148148148,0.013020833333333334,0.017592592592592594
/home/dexter/Desktop/blackbuck/LEK_ANNOTATION/still_images/frame260.jpg,1134,1031,1156,1056,1145.0,1043.5,1080,1920,25,22,0,0.5963541666666666,0.9662037037037037,0.011458333333333333,0.023148148148148147
/home/dexter/Desktop/blackbuck/LEK_ANNOTATION/still_images/frame260.jpg,1160,1011,1176,1031,1168.0,1021.0,1080,1920,20,16,0,0.6083333333333333,0.9453703703703704,0.008333333333333333,0.018518518518518517
/home/dexter/Desktop/blackbuck/LEK_ANNOTATION/still_images/frame260.jpg,1197,1034,1216,1058,1206.5,1046.0,1080,1920,24,19,0,0.6283854166666667,0.9685185185185186,0.009895833333333333,0.022222222222222223
/home/dexter/Desktop/blackbuck/LEK_ANNOTATION/still_images/frame260.jpg,1187,973,1208,996,1197.5,984.5,1080,1920,23,21,0,0.6236979166666666,0.9115740740740741,0.0109375,0.021296296296296296
/home/dexter/Desktop/blackbuck/LEK_ANNOTATION/still_images/frame260.jpg,1275,921,1303,942,1289.0,931.5,1080,1920,21,28,0,0.6713541666666667,0.8625,0.014583333333333334,0.019444444444444445
/home/dexter/Desktop/blackbuck/LEK_ANNOTATION/still_images/frame260.jpg,1267,882,1289,903,1278.0,892.5,1080,1920,21,22,0,0.665625,0.8263888888888888,0.011458333333333333,0.019444444444444445
/home/dexter/Desktop/blackbuck/LEK_ANNOTATION/still_images/frame260.jpg,1296,876,1320,897,1308.0,886.5,1080,1920,21,24,0,0.68125,0.8208333333333333,0.0125,0.019444444444444445
/home/dexter/Desktop/blackbuck/LEK_ANNOTATION/still_images/frame260.jpg,1295,840,1318,863,1306.5,851.5,1080,1920,23,23,0,0.68046875,0.788425925925926,0.011979166666666667,0.021296296296296296
/home/dexter/Desktop/blackbuck/LEK_ANNOTATION/still_images/frame260.jpg,1386,743,1409,768,1397.5,755.5,1080,1920,25,23,0,0.7278645833333334,0.6995370370370371,0.011979166666666667,0.023148148148148147
/home/dexter/Desktop/blackbuck/LEK_ANNOTATION/still_images/frame260.jpg,1411,725,1435,741,1423.0,733.0,1080,1920,16,24,0,0.7411458333333333,0.6787037037037037,0.0125,0.014814814814814815
/home/dexter/Desktop/blackbuck/LEK_ANNOTATION/still_images/frame260.jpg,1439,705,1465,723,1452.0,714.0,1080,1920,18,26,0,0.75625,0.6611111111111111,0.013541666666666667,0.016666666666666666
/home/dexter/Desktop/blackbuck/LEK_ANNOTATION/still_images/frame260.jpg,1491,655,1511,683,1501.0,669.0,1080,1920,28,20,0,0.7817708333333333,0.6194444444444445,0.010416666666666666,0.025925925925925925
/home/dexter/Desktop/blackbuck/LEK_ANNOTATION/still_images/frame260.jpg,1592,575,1621,596,1606.5,585.5,1080,1920,21,29,0,0.83671875,0.5421296296296296,0.015104166666666667,0.019444444444444445
/home/dexter/Desktop/blackbuck/LEK_ANNOTATION/still_images/frame260.jpg,1678,521,1707,539,1692.5,530.0,1080,1920,18,29,0,0.8815104166666666,0.49074074074074076,0.015104166666666667,0.016666666666666666
/home/dexter/Desktop/blackbuck/LEK_ANNOTATION/still_images/frame260.jpg,1871,362,1896,378,1883.5,370.0,1080,1920,16,25,0,0.9809895833333333,0.3425925925925926,0.013020833333333334,0.014814814814814815
/home/dexter/Desktop/blackbuck/LEK_ANNOTATION/still_images/frame260.jpg,1840,295,1856,317,1848.0,306.0,1080,1920,22,16,0,0.9625,0.2833333333333333,0.008333333333333333,0.020370370370370372
/home/dexter/Desktop/blackbuck/LEK_ANNOTATION/still_images/frame260.jpg,1867,258,1891,279,1879.0,268.5,1080,1920,21,24,0,0.9786458333333333,0.24861111111111112,0.0125,0.019444444444444445
/home/dexter/Desktop/blackbuck/LEK_ANNOTATION/still_images/frame94.jpg,525,672,548,697,536.5,684.5,1080,1920,25,23,0,0.2794270833333333,0.6337962962962963,0.011979166666666667,0.023148148148148147
/home/dexter/Desktop/blackbuck/LEK_ANNOTATION/still_images/frame94.jpg,564,631,585,653,574.5,642.0,1080,1920,22,21,0,0.29921875,0.5944444444444444,0.0109375,0.020370370370370372
/home/dexter/Desktop/blackbuck/LEK_ANNOTATION/still_images/frame94.jpg,596,589,617,612,606.5,600.5,1080,1920,23,21,0,0.31588541666666664,0.5560185185185185,0.0109375,0.021296296296296296
/home/dexter/Desktop/blackbuck/LEK_ANNOTATION/still_images/frame94.jpg,737,559,756,574,746.5,566.5,1080,1920,15,19,0,0.3888020833333333,0.524537037037037,0.009895833333333333,0.013888888888888888
/home/dexter/Desktop/blackbuck/LEK_ANNOTATION/still_images/frame94.jpg,736,472,758,496,747.0,484.0,1080,1920,24,22,0,0.3890625,0.44814814814814813,0.011458333333333333,0.022222222222222223
/home/dexter/Desktop/blackbuck/LEK_ANNOTATION/still_images/frame94.jpg,772,443,794,461,783.0,452.0,1080,1920,18,22,0,0.4078125,0.4185185185185185,0.011458333333333333,0.016666666666666666
/home/dexter/Desktop/blackbuck/LEK_ANNOTATION/still_images/frame94.jpg,795,408,813,432,804.0,420.0,1080,1920,24,18,0,0.41875,0.3888888888888889,0.009375,0.022222222222222223
/home/dexter/Desktop/blackbuck/LEK_ANNOTATION/still_images/frame94.jpg,893,333,917,353,905.0,343.0,1080,1920,20,24,0,0.4713541666666667,0.3175925925925926,0.0125,0.018518518518518517
/home/dexter/Desktop/blackbuck/LEK_ANNOTATION/still_images/frame94.jpg,964,271,990,286,977.0,278.5,1080,1920,15,26,0,0.5088541666666667,0.25787037037037036,0.013541666666666667,0.013888888888888888
/home/dexter/Desktop/blackbuck/LEK_ANNOTATION/still_images/frame94.jpg,913,743,934,761,923.5,752.0,1080,1920,18,21,0,0.48098958333333336,0.6962962962962963,0.0109375,0.016666666666666666
/home/dexter/Desktop/blackbuck/LEK_ANNOTATION/still_images/frame94.jpg,611,1020,627,1040,619.0,1030.0,1080,1920,20,16,0,0.3223958333333333,0.9537037037037037,0.008333333333333333,0.018518518518518517
/home/dexter/Desktop/blackbuck/LEK_ANNOTATION/still_images/frame94.jpg,852,970,865,1003,858.5,986.5,1080,1920,33,13,0,0.4471354166666667,0.913425925925926,0.0067708333333333336,0.030555555555555555
/home/dexter/Desktop/blackbuck/LEK_ANNOTATION/still_images/frame94.jpg,1125,1038,1143,1064,1134.0,1051.0,1080,1920,26,18,0,0.590625,0.9731481481481481,0.009375,0.024074074074074074
/home/dexter/Desktop/blackbuck/LEK_ANNOTATION/still_images/frame94.jpg,1154,1009,1174,1031,1164.0,1020.0,1080,1920,22,20,0,0.60625,0.9444444444444444,0.010416666666666666,0.020370370370370372
/home/dexter/Desktop/blackbuck/LEK_ANNOTATION/still_images/frame94.jpg,1183,1056,1200,1077,1191.5,1066.5,1080,1920,21,17,0,0.6205729166666667,0.9875,0.008854166666666666,0.019444444444444445
/home/dexter/Desktop/blackbuck/LEK_ANNOTATION/still_images/frame94.jpg,1199,964,1222,984,1210.5,974.0,1080,1920,20,23,0,0.63046875,0.9018518518518519,0.011979166666666667,0.018518518518518517
/home/dexter/Desktop/blackbuck/LEK_ANNOTATION/still_images/frame94.jpg,1246,951,1264,971,1255.0,961.0,1080,1920,20,18,0,0.6536458333333334,0.8898148148148148,0.009375,0.018518518518518517
/home/dexter/Desktop/blackbuck/LEK_ANNOTATION/still_images/frame94.jpg,1239,907,1258,932,1248.5,919.5,1080,1920,25,19,0,0.6502604166666667,0.8513888888888889,0.009895833333333333,0.023148148148148147
/home/dexter/Desktop/blackbuck/LEK_ANNOTATION/still_images/frame94.jpg,1269,900,1294,921,1281.5,910.5,1080,1920,21,25,0,0.6674479166666667,0.8430555555555556,0.013020833333333334,0.019444444444444445
/home/dexter/Desktop/blackbuck/LEK_ANNOTATION/still_images/frame94.jpg,1273,876,1303,894,1288.0,885.0,1080,1920,18,30,0,0.6708333333333333,0.8194444444444444,0.015625,0.016666666666666666
/home/dexter/Desktop/blackbuck/LEK_ANNOTATION/still_images/frame94.jpg,1348,773,1369,798,1358.5,785.5,1080,1920,25,21,0,0.7075520833333333,0.7273148148148149,0.0109375,0.023148148148148147
/home/dexter/Desktop/blackbuck/LEK_ANNOTATION/still_images/frame94.jpg,1374,758,1395,777,1384.5,767.5,1080,1920,19,21,0,0.72109375,0.7106481481481481,0.0109375,0.017592592592592594
/home/dexter/Desktop/blackbuck/LEK_ANNOTATION/still_images/frame94.jpg,1399,727,1422,747,1410.5,737.0,1080,1920,20,23,0,0.7346354166666667,0.6824074074074075,0.011979166666666667,0.018518518518518517
/home/dexter/Desktop/blackbuck/LEK_ANNOTATION/still_images/frame94.jpg,1448,692,1478,710,1463.0,701.0,1080,1920,18,30,0,0.7619791666666667,0.649074074074074,0.015625,0.016666666666666666
/home/dexter/Desktop/blackbuck/LEK_ANNOTATION/still_images/frame94.jpg,1552,607,1576,625,1564.0,616.0,1080,1920,18,24,0,0.8145833333333333,0.5703703703703704,0.0125,0.016666666666666666
/home/dexter/Desktop/blackbuck/LEK_ANNOTATION/still_images/frame94.jpg,1637,541,1665,559,1651.0,550.0,1080,1920,18,28,0,0.8598958333333333,0.5092592592592593,0.014583333333333334,0.016666666666666666
/home/dexter/Desktop/blackbuck/LEK_ANNOTATION/still_images/frame94.jpg,1715,498,1741,513,1728.0,505.5,1080,1920,15,26,0,0.9,0.46805555555555556,0.013541666666666667,0.013888888888888888
/home/dexter/Desktop/blackbuck/LEK_ANNOTATION/still_images/frame94.jpg,1829,388,1855,405,1842.0,396.5,1080,1920,17,26,0,0.959375,0.36712962962962964,0.013541666666666667,0.01574074074074074
/home/dexter/Desktop/blackbuck/LEK_ANNOTATION/still_images/frame94.jpg,1836,288,1854,315,1845.0,301.5,1080,1920,27,18,0,0.9609375,0.2791666666666667,0.009375,0.025
/home/dexter/Desktop/blackbuck/LEK_ANNOTATION/still_images/frame94.jpg,1880,255,1906,275,1893.0,265.0,1080,1920,20,26,0,0.9859375,0.24537037037037038,0.013541666666666667,0.018518518518518517
/home/dexter/Desktop/blackbuck/LEK_ANNOTATION/still_images/frame304.jpg,570,635,585,650,577.5,642.5,1080,1920,15,15,0,0.30078125,0.5949074074074074,0.0078125,0.013888888888888888
/home/dexter/Desktop/blackbuck/LEK_ANNOTATION/still_images/frame304.jpg,609,587,624,605,616.5,596.0,1080,1920,18,15,0,0.32109375,0.5518518518518518,0.0078125,0.016666666666666666
/home/dexter/Desktop/blackbuck/LEK_ANNOTATION/still_images/frame304.jpg,642,554,667,574,654.5,564.0,1080,1920,20,25,0,0.34088541666666666,0.5222222222222223,0.013020833333333334,0.018518518518518517
/home/dexter/Desktop/blackbuck/LEK_ANNOTATION/still_images/frame304.jpg,783,521,797,540,790.0,530.5,1080,1920,19,14,0,0.4114583333333333,0.4912037037037037,0.007291666666666667,0.017592592592592594
/home/dexter/Desktop/blackbuck/LEK_ANNOTATION/still_images/frame304.jpg,787,425,804,448,795.5,436.5,1080,1920,23,17,0,0.41432291666666665,0.4041666666666667,0.008854166666666666,0.021296296296296296
/home/dexter/Desktop/blackbuck/LEK_ANNOTATION/still_images/frame304.jpg,831,427,854,447,842.5,437.0,1080,1920,20,23,0,0.4388020833333333,0.4046296296296296,0.011979166666666667,0.018518518518518517
/home/dexter/Desktop/blackbuck/LEK_ANNOTATION/still_images/frame304.jpg,843,376,859,394,851.0,385.0,1080,1920,18,16,0,0.4432291666666667,0.35648148148148145,0.008333333333333333,0.016666666666666666
/home/dexter/Desktop/blackbuck/LEK_ANNOTATION/still_images/frame304.jpg,941,298,959,316,950.0,307.0,1080,1920,18,18,0,0.4947916666666667,0.28425925925925927,0.009375,0.016666666666666666
/home/dexter/Desktop/blackbuck/LEK_ANNOTATION/still_images/frame304.jpg,1020,266,1042,279,1031.0,272.5,1080,1920,13,22,0,0.5369791666666667,0.2523148148148148,0.011458333333333333,0.012037037037037037
/home/dexter/Desktop/blackbuck/LEK_ANNOTATION/still_images/frame304.jpg,965,723,993,736,979.0,729.5,1080,1920,13,28,0,0.5098958333333333,0.6754629629629629,0.014583333333333334,0.012037037037037037
/home/dexter/Desktop/blackbuck/LEK_ANNOTATION/still_images/frame304.jpg,856,967,870,1000,863.0,983.5,1080,1920,33,14,0,0.44947916666666665,0.9106481481481481,0.007291666666666667,0.030555555555555555
/home/dexter/Desktop/blackbuck/LEK_ANNOTATION/still_images/frame304.jpg,1131,1061,1141,1078,1136.0,1069.5,1080,1920,17,10,0,0.5916666666666667,0.9902777777777778,0.005208333333333333,0.01574074074074074
/home/dexter/Desktop/blackbuck/LEK_ANNOTATION/still_images/frame304.jpg,1145,1026,1165,1047,1155.0,1036.5,1080,1920,21,20,0,0.6015625,0.9597222222222223,0.010416666666666666,0.019444444444444445
/home/dexter/Desktop/blackbuck/LEK_ANNOTATION/still_images/frame304.jpg,1170,1001,1184,1019,1177.0,1010.0,1080,1920,18,14,0,0.6130208333333333,0.9351851851851852,0.007291666666666667,0.016666666666666666
/home/dexter/Desktop/blackbuck/LEK_ANNOTATION/still_images/frame304.jpg,1198,1032,1215,1054,1206.5,1043.0,1080,1920,22,17,0,0.6283854166666667,0.9657407407407408,0.008854166666666666,0.020370370370370372
/home/dexter/Desktop/blackbuck/LEK_ANNOTATION/still_images/frame304.jpg,1198,959,1215,982,1206.5,970.5,1080,1920,23,17,0,0.6283854166666667,0.8986111111111111,0.008854166666666666,0.021296296296296296
/home/dexter/Desktop/blackbuck/LEK_ANNOTATION/still_images/frame304.jpg,1240,914,1261,934,1250.5,924.0,1080,1920,20,21,0,0.6513020833333333,0.8555555555555555,0.0109375,0.018518518518518517
/home/dexter/Desktop/blackbuck/LEK_ANNOTATION/still_images/frame304.jpg,1290,918,1316,934,1303.0,926.0,1080,1920,16,26,0,0.6786458333333333,0.8574074074074074,0.013541666666666667,0.014814814814814815
/home/dexter/Desktop/blackbuck/LEK_ANNOTATION/still_images/frame304.jpg,1276,874,1295,894,1285.5,884.0,1080,1920,20,19,0,0.66953125,0.8185185185185185,0.009895833333333333,0.018518518518518517
/home/dexter/Desktop/blackbuck/LEK_ANNOTATION/still_images/frame304.jpg,1307,869,1331,889,1319.0,879.0,1080,1920,20,24,0,0.6869791666666667,0.8138888888888889,0.0125,0.018518518518518517
/home/dexter/Desktop/blackbuck/LEK_ANNOTATION/still_images/frame304.jpg,1302,829,1323,854,1312.5,841.5,1080,1920,25,21,0,0.68359375,0.7791666666666667,0.0109375,0.023148148148148147
/home/dexter/Desktop/blackbuck/LEK_ANNOTATION/still_images/frame304.jpg,1397,736,1420,755,1408.5,745.5,1080,1920,19,23,0,0.73359375,0.6902777777777778,0.011979166666666667,0.017592592592592594
/home/dexter/Desktop/blackbuck/LEK_ANNOTATION/still_images/frame304.jpg,1424,716,1444,732,1434.0,724.0,1080,1920,16,20,0,0.746875,0.6703703703703704,0.010416666666666666,0.014814814814814815
/home/dexter/Desktop/blackbuck/LEK_ANNOTATION/still_images/frame304.jpg,1448,692,1473,711,1460.5,701.5,1080,1920,19,25,0,0.7606770833333333,0.649537037037037,0.013020833333333334,0.017592592592592594
/home/dexter/Desktop/blackbuck/LEK_ANNOTATION/still_images/frame304.jpg,1493,644,1519,667,1506.0,655.5,1080,1920,23,26,0,0.784375,0.6069444444444444,0.013541666666666667,0.021296296296296296
/home/dexter/Desktop/blackbuck/LEK_ANNOTATION/still_images/frame304.jpg,1600,566,1629,586,1614.5,576.0,1080,1920,20,29,0,0.8408854166666667,0.5333333333333333,0.015104166666666667,0.018518518518518517
/home/dexter/Desktop/blackbuck/LEK_ANNOTATION/still_images/frame304.jpg,1692,514,1715,529,1703.5,521.5,1080,1920,15,23,0,0.8872395833333333,0.4828703703703704,0.011979166666666667,0.013888888888888888
/home/dexter/Desktop/blackbuck/LEK_ANNOTATION/still_images/frame304.jpg,1843,286,1863,308,1853.0,297.0,1080,1920,22,20,0,0.9651041666666667,0.275,0.010416666666666666,0.020370370370370372
/home/dexter/Desktop/blackbuck/LEK_ANNOTATION/still_images/frame304.jpg,1879,252,1902,269,1890.5,260.5,1080,1920,17,23,0,0.9846354166666667,0.2412037037037037,0.011979166666666667,0.01574074074074074
/home/dexter/Desktop/blackbuck/LEK_ANNOTATION/still_images/frame304.jpg,1879,359,1906,375,1892.5,367.0,1080,1920,16,27,0,0.9856770833333334,0.3398148148148148,0.0140625,0.014814814814814815
/home/dexter/Desktop/blackbuck/LEK_ANNOTATION/still_images/frame304.jpg,613,1017,631,1039,622.0,1028.0,1080,1920,22,18,0,0.32395833333333335,0.9518518518518518,0.009375,0.020370370370370372
/home/dexter/Desktop/blackbuck/LEK_ANNOTATION/still_images/frame158.jpg,542,665,555,682,548.5,673.5,1080,1920,17,13,0,0.28567708333333336,0.6236111111111111,0.0067708333333333336,0.01574074074074074
/home/dexter/Desktop/blackbuck/LEK_ANNOTATION/still_images/frame158.jpg,578,615,596,637,587.0,626.0,1080,1920,22,18,0,0.30572916666666666,0.5796296296296296,0.009375,0.020370370370370372
/home/dexter/Desktop/blackbuck/LEK_ANNOTATION/still_images/frame158.jpg,614,578,630,598,622.0,588.0,1080,1920,20,16,0,0.32395833333333335,0.5444444444444444,0.008333333333333333,0.018518518518518517
/home/dexter/Desktop/blackbuck/LEK_ANNOTATION/still_images/frame158.jpg,755,548,773,560,764.0,554.0,1080,1920,12,18,0,0.39791666666666664,0.512962962962963,0.009375,0.011111111111111112
/home/dexter/Desktop/blackbuck/LEK_ANNOTATION/still_images/frame158.jpg,756,463,774,483,765.0,473.0,1080,1920,20,18,0,0.3984375,0.43796296296296294,0.009375,0.018518518518518517
/home/dexter/Desktop/blackbuck/LEK_ANNOTATION/still_images/frame158.jpg,789,439,818,455,803.5,447.0,1080,1920,16,29,0,0.41848958333333336,0.41388888888888886,0.015104166666666667,0.014814814814814815
/home/dexter/Desktop/blackbuck/LEK_ANNOTATION/still_images/frame158.jpg,812,401,829,417,820.5,409.0,1080,1920,16,17,0,0.42734375,0.3787037037037037,0.008854166666666666,0.014814814814814815
/home/dexter/Desktop/blackbuck/LEK_ANNOTATION/still_images/frame158.jpg,909,321,931,343,920.0,332.0,1080,1920,22,22,0,0.4791666666666667,0.3074074074074074,0.011458333333333333,0.020370370370370372
/home/dexter/Desktop/blackbuck/LEK_ANNOTATION/still_images/frame158.jpg,981,269,1006,282,993.5,275.5,1080,1920,13,25,0,0.5174479166666667,0.2550925925925926,0.013020833333333334,0.012037037037037037
/home/dexter/Desktop/blackbuck/LEK_ANNOTATION/still_images/frame158.jpg,933,737,954,752,943.5,744.5,1080,1920,15,21,0,0.49140625,0.6893518518518519,0.0109375,0.013888888888888888
/home/dexter/Desktop/blackbuck/LEK_ANNOTATION/still_images/frame158.jpg,614,1017,626,1039,620.0,1028.0,1080,1920,22,12,0,0.3229166666666667,0.9518518518518518,0.00625,0.020370370370370372
/home/dexter/Desktop/blackbuck/LEK_ANNOTATION/still_images/frame158.jpg,853,971,868,1003,860.5,987.0,1080,1920,32,15,0,0.44817708333333334,0.9138888888888889,0.0078125,0.02962962962962963
/home/dexter/Desktop/blackbuck/LEK_ANNOTATION/still_images/frame158.jpg,1140,1026,1157,1047,1148.5,1036.5,1080,1920,21,17,0,0.5981770833333333,0.9597222222222223,0.008854166666666666,0.019444444444444445
/home/dexter/Desktop/blackbuck/LEK_ANNOTATION/still_images/frame158.jpg,1170,994,1189,1019,1179.5,1006.5,1080,1920,25,19,0,0.6143229166666667,0.9319444444444445,0.009895833333333333,0.023148148148148147
/home/dexter/Desktop/blackbuck/LEK_ANNOTATION/still_images/frame158.jpg,1190,1040,1208,1066,1199.0,1053.0,1080,1920,26,18,0,0.6244791666666667,0.975,0.009375,0.024074074074074074
/home/dexter/Desktop/blackbuck/LEK_ANNOTATION/still_images/frame158.jpg,1252,899,1271,917,1261.5,908.0,1080,1920,18,19,0,0.65703125,0.8407407407407408,0.009895833333333333,0.016666666666666666
/home/dexter/Desktop/blackbuck/LEK_ANNOTATION/still_images/frame158.jpg,1259,939,1280,961,1269.5,950.0,1080,1920,22,21,0,0.6611979166666667,0.8796296296296297,0.0109375,0.020370370370370372
/home/dexter/Desktop/blackbuck/LEK_ANNOTATION/still_images/frame158.jpg,1284,901,1305,914,1294.5,907.5,1080,1920,13,21,0,0.67421875,0.8402777777777778,0.0109375,0.012037037037037037
/home/dexter/Desktop/blackbuck/LEK_ANNOTATION/still_images/frame158.jpg,1286,863,1304,887,1295.0,875.0,1080,1920,24,18,0,0.6744791666666666,0.8101851851851852,0.009375,0.022222222222222223
/home/dexter/Desktop/blackbuck/LEK_ANNOTATION/still_images/frame158.jpg,1363,767,1388,786,1375.5,776.5,1080,1920,19,25,0,0.71640625,0.7189814814814814,0.013020833333333334,0.017592592592592594
/home/dexter/Desktop/blackbuck/LEK_ANNOTATION/still_images/frame158.jpg,1387,746,1410,761,1398.5,753.5,1080,1920,15,23,0,0.7283854166666667,0.6976851851851852,0.011979166666666667,0.013888888888888888
/home/dexter/Desktop/blackbuck/LEK_ANNOTATION/still_images/frame158.jpg,1417,722,1441,742,1429.0,732.0,1080,1920,20,24,0,0.7442708333333333,0.6777777777777778,0.0125,0.018518518518518517
/home/dexter/Desktop/blackbuck/LEK_ANNOTATION/still_images/frame158.jpg,1469,679,1495,700,1482.0,689.5,1080,1920,21,26,0,0.771875,0.638425925925926,0.013541666666666667,0.019444444444444445
/home/dexter/Desktop/blackbuck/LEK_ANNOTATION/still_images/frame158.jpg,1569,593,1596,611,1582.5,602.0,1080,1920,18,27,0,0.82421875,0.5574074074074075,0.0140625,0.016666666666666666
/home/dexter/Desktop/blackbuck/LEK_ANNOTATION/still_images/frame158.jpg,1656,533,1684,548,1670.0,540.5,1080,1920,15,28,0,0.8697916666666666,0.500462962962963,0.014583333333333334,0.013888888888888888
/home/dexter/Desktop/blackbuck/LEK_ANNOTATION/still_images/frame158.jpg,1729,497,1755,507,1742.0,502.0,1080,1920,10,26,0,0.9072916666666667,0.4648148148148148,0.013541666666666667,0.009259259259259259
/home/dexter/Desktop/blackbuck/LEK_ANNOTATION/still_images/frame158.jpg,1842,380,1872,396,1857.0,388.0,1080,1920,16,30,0,0.9671875,0.3592592592592593,0.015625,0.014814814814814815
/home/dexter/Desktop/blackbuck/LEK_ANNOTATION/still_images/frame158.jpg,1810,322,1833,339,1821.5,330.5,1080,1920,17,23,0,0.9486979166666667,0.3060185185185185,0.011979166666666667,0.01574074074074074
/home/dexter/Desktop/blackbuck/LEK_ANNOTATION/still_images/frame158.jpg,1847,282,1868,298,1857.5,290.0,1080,1920,16,21,0,0.9674479166666666,0.26851851851851855,0.0109375,0.014814814814814815
/home/dexter/Desktop/blackbuck/LEK_ANNOTATION/still_images/frame158.jpg,1896,241,1918,261,1907.0,251.0,1080,1920,20,22,0,0.9932291666666667,0.2324074074074074,0.011458333333333333,0.018518518518518517
/home/dexter/Desktop/blackbuck/LEK_ANNOTATION/still_images/frame100.jpg,526,677,543,695,534.5,686.0,1080,1920,18,17,0,0.27838541666666666,0.6351851851851852,0.008854166666666666,0.016666666666666666
/home/dexter/Desktop/blackbuck/LEK_ANNOTATION/still_images/frame100.jpg,564,634,582,648,573.0,641.0,1080,1920,14,18,0,0.2984375,0.5935185185185186,0.009375,0.012962962962962963
/home/dexter/Desktop/blackbuck/LEK_ANNOTATION/still_images/frame100.jpg,600,593,615,610,607.5,601.5,1080,1920,17,15,0,0.31640625,0.5569444444444445,0.0078125,0.01574074074074074
/home/dexter/Desktop/blackbuck/LEK_ANNOTATION/still_images/frame100.jpg,737,558,760,575,748.5,566.5,1080,1920,17,23,0,0.38984375,0.524537037037037,0.011979166666666667,0.01574074074074074
/home/dexter/Desktop/blackbuck/LEK_ANNOTATION/still_images/frame100.jpg,739,474,757,493,748.0,483.5,1080,1920,19,18,0,0.38958333333333334,0.4476851851851852,0.009375,0.017592592592592594
/home/dexter/Desktop/blackbuck/LEK_ANNOTATION/still_images/frame100.jpg,774,444,792,464,783.0,454.0,1080,1920,20,18,0,0.4078125,0.4203703703703704,0.009375,0.018518518518518517
/home/dexter/Desktop/blackbuck/LEK_ANNOTATION/still_images/frame100.jpg,795,413,814,430,804.5,421.5,1080,1920,17,19,0,0.41901041666666666,0.3902777777777778,0.009895833333333333,0.01574074074074074
/home/dexter/Desktop/blackbuck/LEK_ANNOTATION/still_images/frame100.jpg,895,334,921,354,908.0,344.0,1080,1920,20,26,0,0.47291666666666665,0.31851851851851853,0.013541666666666667,0.018518518518518517
/home/dexter/Desktop/blackbuck/LEK_ANNOTATION/still_images/frame100.jpg,967,269,987,287,977.0,278.0,1080,1920,18,20,0,0.5088541666666667,0.2574074074074074,0.010416666666666666,0.016666666666666666
/home/dexter/Desktop/blackbuck/LEK_ANNOTATION/still_images/frame100.jpg,913,740,936,762,924.5,751.0,1080,1920,22,23,0,0.48151041666666666,0.6953703703703704,0.011979166666666667,0.020370370370370372
/home/dexter/Desktop/blackbuck/LEK_ANNOTATION/still_images/frame100.jpg,607,1022,624,1041,615.5,1031.5,1080,1920,19,17,0,0.32057291666666665,0.9550925925925926,0.008854166666666666,0.017592592592592594
/home/dexter/Desktop/blackbuck/LEK_ANNOTATION/still_images/frame100.jpg,850,974,867,1003,858.5,988.5,1080,1920,29,17,0,0.4471354166666667,0.9152777777777777,0.008854166666666666,0.026851851851851852
/home/dexter/Desktop/blackbuck/LEK_ANNOTATION/still_images/frame100.jpg,1128,1039,1144,1057,1136.0,1048.0,1080,1920,18,16,0,0.5916666666666667,0.9703703703703703,0.008333333333333333,0.016666666666666666
/home/dexter/Desktop/blackbuck/LEK_ANNOTATION/still_images/frame100.jpg,1157,1011,1179,1030,1168.0,1020.5,1080,1920,19,22,0,0.6083333333333333,0.9449074074074074,0.011458333333333333,0.017592592592592594
/home/dexter/Desktop/blackbuck/LEK_ANNOTATION/still_images/frame100.jpg,1187,1056,1204,1078,1195.5,1067.0,1080,1920,22,17,0,0.62265625,0.9879629629629629,0.008854166666666666,0.020370370370370372
/home/dexter/Desktop/blackbuck/LEK_ANNOTATION/still_images/frame100.jpg,1245,951,1269,972,1257.0,961.5,1080,1920,21,24,0,0.6546875,0.8902777777777777,0.0125,0.019444444444444445
/home/dexter/Desktop/blackbuck/LEK_ANNOTATION/still_images/frame100.jpg,1240,912,1264,929,1252.0,920.5,1080,1920,17,24,0,0.6520833333333333,0.8523148148148149,0.0125,0.01574074074074074
/home/dexter/Desktop/blackbuck/LEK_ANNOTATION/still_images/frame100.jpg,1267,903,1298,920,1282.5,911.5,1080,1920,17,31,0,0.66796875,0.8439814814814814,0.016145833333333335,0.01574074074074074
/home/dexter/Desktop/blackbuck/LEK_ANNOTATION/still_images/frame100.jpg,1274,876,1299,894,1286.5,885.0,1080,1920,18,25,0,0.6700520833333333,0.8194444444444444,0.013020833333333334,0.016666666666666666
/home/dexter/Desktop/blackbuck/LEK_ANNOTATION/still_images/frame100.jpg,1347,773,1372,796,1359.5,784.5,1080,1920,23,25,0,0.7080729166666667,0.7263888888888889,0.013020833333333334,0.021296296296296296
/home/dexter/Desktop/blackbuck/LEK_ANNOTATION/still_images/frame100.jpg,1372,756,1393,776,1382.5,766.0,1080,1920,20,21,0,0.7200520833333334,0.7092592592592593,0.0109375,0.018518518518518517
/home/dexter/Desktop/blackbuck/LEK_ANNOTATION/still_images/frame100.jpg,1395,725,1424,749,1409.5,737.0,1080,1920,24,29,0,0.7341145833333333,0.6824074074074075,0.015104166666666667,0.022222222222222223
/home/dexter/Desktop/blackbuck/LEK_ANNOTATION/still_images/frame100.jpg,1451,689,1480,709,1465.5,699.0,1080,1920,20,29,0,0.76328125,0.6472222222222223,0.015104166666666667,0.018518518518518517
/home/dexter/Desktop/blackbuck/LEK_ANNOTATION/still_images/frame100.jpg,1554,604,1577,623,1565.5,613.5,1080,1920,19,23,0,0.8153645833333333,0.5680555555555555,0.011979166666666667,0.017592592592592594
/home/dexter/Desktop/blackbuck/LEK_ANNOTATION/still_images/frame100.jpg,1637,536,1669,556,1653.0,546.0,1080,1920,20,32,0,0.8609375,0.5055555555555555,0.016666666666666666,0.018518518518518517
/home/dexter/Desktop/blackbuck/LEK_ANNOTATION/still_images/frame100.jpg,1714,495,1740,515,1727.0,505.0,1080,1920,20,26,0,0.8994791666666667,0.4675925925925926,0.013541666666666667,0.018518518518518517
/home/dexter/Desktop/blackbuck/LEK_ANNOTATION/still_images/frame100.jpg,1828,385,1857,405,1842.5,395.0,1080,1920,20,29,0,0.9596354166666666,0.36574074074074076,0.015104166666666667,0.018518518518518517
/home/dexter/Desktop/blackbuck/LEK_ANNOTATION/still_images/frame100.jpg,1795,331,1823,347,1809.0,339.0,1080,1920,16,28,0,0.9421875,0.3138888888888889,0.014583333333333334,0.014814814814814815
/home/dexter/Desktop/blackbuck/LEK_ANNOTATION/still_images/frame100.jpg,1837,287,1857,314,1847.0,300.5,1080,1920,27,20,0,0.9619791666666667,0.27824074074074073,0.010416666666666666,0.025
/home/dexter/Desktop/blackbuck/LEK_ANNOTATION/still_images/frame100.jpg,1884,256,1909,275,1896.5,265.5,1080,1920,19,25,0,0.9877604166666667,0.24583333333333332,0.013020833333333334,0.017592592592592594
/home/dexter/Desktop/blackbuck/LEK_ANNOTATION/still_images/frame524.jpg,571,626,591,648,581.0,637.0,1080,1920,22,20,0,0.3026041666666667,0.5898148148148148,0.010416666666666666,0.020370370370370372
/home/dexter/Desktop/blackbuck/LEK_ANNOTATION/still_images/frame524.jpg,613,584,627,600,620.0,592.0,1080,1920,16,14,0,0.3229166666666667,0.5481481481481482,0.007291666666666667,0.014814814814814815
/home/dexter/Desktop/blackbuck/LEK_ANNOTATION/still_images/frame524.jpg,656,542,674,562,665.0,552.0,1080,1920,20,18,0,0.3463541666666667,0.5111111111111111,0.009375,0.018518518518518517
/home/dexter/Desktop/blackbuck/LEK_ANNOTATION/still_images/frame524.jpg,706,542,730,558,718.0,550.0,1080,1920,16,24,0,0.37395833333333334,0.5092592592592593,0.0125,0.014814814814814815
/home/dexter/Desktop/blackbuck/LEK_ANNOTATION/still_images/frame524.jpg,822,480,838,504,830.0,492.0,1080,1920,24,16,0,0.4322916666666667,0.45555555555555555,0.008333333333333333,0.022222222222222223
/home/dexter/Desktop/blackbuck/LEK_ANNOTATION/still_images/frame524.jpg,832,374,857,394,844.5,384.0,1080,1920,20,25,0,0.43984375,0.35555555555555557,0.013020833333333334,0.018518518518518517
/home/dexter/Desktop/blackbuck/LEK_ANNOTATION/still_images/frame524.jpg,887,401,910,415,898.5,408.0,1080,1920,14,23,0,0.46796875,0.37777777777777777,0.011979166666666667,0.012962962962962963
/home/dexter/Desktop/blackbuck/LEK_ANNOTATION/still_images/frame524.jpg,893,335,915,349,904.0,342.0,1080,1920,14,22,0,0.4708333333333333,0.31666666666666665,0.011458333333333333,0.012962962962962963
/home/dexter/Desktop/blackbuck/LEK_ANNOTATION/still_images/frame524.jpg,1003,267,1023,284,1013.0,275.5,1080,1920,17,20,0,0.5276041666666667,0.2550925925925926,0.010416666666666666,0.01574074074074074
/home/dexter/Desktop/blackbuck/LEK_ANNOTATION/still_images/frame524.jpg,1087,244,1110,262,1098.5,253.0,1080,1920,18,23,0,0.5721354166666667,0.23425925925925925,0.011979166666666667,0.016666666666666666
/home/dexter/Desktop/blackbuck/LEK_ANNOTATION/still_images/frame524.jpg,655,992,679,1005,667.0,998.5,1080,1920,13,24,0,0.34739583333333335,0.924537037037037,0.0125,0.012037037037037037
/home/dexter/Desktop/blackbuck/LEK_ANNOTATION/still_images/frame524.jpg,863,965,877,995,870.0,980.0,1080,1920,30,14,0,0.453125,0.9074074074074074,0.007291666666666667,0.027777777777777776
/home/dexter/Desktop/blackbuck/LEK_ANNOTATION/still_images/frame524.jpg,1023,682,1050,700,1036.5,691.0,1080,1920,18,27,0,0.53984375,0.6398148148148148,0.0140625,0.016666666666666666
/home/dexter/Desktop/blackbuck/LEK_ANNOTATION/still_images/frame524.jpg,1113,1066,1129,1077,1121.0,1071.5,1080,1920,11,16,0,0.5838541666666667,0.9921296296296296,0.008333333333333333,0.010185185185185186
/home/dexter/Desktop/blackbuck/LEK_ANNOTATION/still_images/frame524.jpg,1131,1052,1142,1072,1136.5,1062.0,1080,1920,20,11,0,0.5919270833333333,0.9833333333333333,0.005729166666666666,0.018518518518518517
/home/dexter/Desktop/blackbuck/LEK_ANNOTATION/still_images/frame524.jpg,1141,1033,1162,1056,1151.5,1044.5,1080,1920,23,21,0,0.5997395833333333,0.9671296296296297,0.0109375,0.021296296296296296
/home/dexter/Desktop/blackbuck/LEK_ANNOTATION/still_images/frame524.jpg,1164,1007,1189,1028,1176.5,1017.5,1080,1920,21,25,0,0.6127604166666667,0.9421296296296297,0.013020833333333334,0.019444444444444445
/home/dexter/Desktop/blackbuck/LEK_ANNOTATION/still_images/frame524.jpg,1198,967,1215,988,1206.5,977.5,1080,1920,21,17,0,0.6283854166666667,0.9050925925925926,0.008854166666666666,0.019444444444444445
/home/dexter/Desktop/blackbuck/LEK_ANNOTATION/still_images/frame524.jpg,1215,946,1230,967,1222.5,956.5,1080,1920,21,15,0,0.63671875,0.8856481481481482,0.0078125,0.019444444444444445
/home/dexter/Desktop/blackbuck/LEK_ANNOTATION/still_images/frame524.jpg,1230,988,1251,1007,1240.5,997.5,1080,1920,19,21,0,0.64609375,0.9236111111111112,0.0109375,0.017592592592592594
/home/dexter/Desktop/blackbuck/LEK_ANNOTATION/still_images/frame524.jpg,1246,911,1271,926,1258.5,918.5,1080,1920,15,25,0,0.65546875,0.850462962962963,0.013020833333333334,0.013888888888888888
/home/dexter/Desktop/blackbuck/LEK_ANNOTATION/still_images/frame524.jpg,1295,860,1310,888,1302.5,874.0,1080,1920,28,15,0,0.6783854166666666,0.8092592592592592,0.0078125,0.025925925925925925
/home/dexter/Desktop/blackbuck/LEK_ANNOTATION/still_images/frame524.jpg,1315,817,1333,838,1324.0,827.5,1080,1920,21,18,0,0.6895833333333333,0.7662037037037037,0.009375,0.019444444444444445
/home/dexter/Desktop/blackbuck/LEK_ANNOTATION/still_images/frame524.jpg,1344,873,1369,889,1356.5,881.0,1080,1920,16,25,0,0.7065104166666667,0.8157407407407408,0.013020833333333334,0.014814814814814815
/home/dexter/Desktop/blackbuck/LEK_ANNOTATION/still_images/frame524.jpg,1357,828,1376,847,1366.5,837.5,1080,1920,19,19,0,0.71171875,0.7754629629629629,0.009895833333333333,0.017592592592592594
/home/dexter/Desktop/blackbuck/LEK_ANNOTATION/still_images/frame524.jpg,1350,791,1366,815,1358.0,803.0,1080,1920,24,16,0,0.7072916666666667,0.7435185185185185,0.008333333333333333,0.022222222222222223
/home/dexter/Desktop/blackbuck/LEK_ANNOTATION/still_images/frame524.jpg,1457,688,1479,706,1468.0,697.0,1080,1920,18,22,0,0.7645833333333333,0.6453703703703704,0.011458333333333333,0.016666666666666666
/home/dexter/Desktop/blackbuck/LEK_ANNOTATION/still_images/frame524.jpg,1484,674,1503,689,1493.5,681.5,1080,1920,15,19,0,0.7778645833333333,0.6310185185185185,0.009895833333333333,0.013888888888888888
/home/dexter/Desktop/blackbuck/LEK_ANNOTATION/still_images/frame524.jpg,1502,646,1521,665,1511.5,655.5,1080,1920,19,19,0,0.7872395833333333,0.6069444444444444,0.009895833333333333,0.017592592592592594
/home/dexter/Desktop/blackbuck/LEK_ANNOTATION/still_images/frame524.jpg,1546,609,1574,621,1560.0,615.0,1080,1920,12,28,0,0.8125,0.5694444444444444,0.014583333333333334,0.011111111111111112
/home/dexter/Desktop/blackbuck/LEK_ANNOTATION/still_images/frame524.jpg,1656,533,1679,547,1667.5,540.0,1080,1920,14,23,0,0.8684895833333334,0.5,0.011979166666666667,0.012962962962962963
/home/dexter/Desktop/blackbuck/LEK_ANNOTATION/still_images/frame524.jpg,1749,494,1765,509,1757.0,501.5,1080,1920,15,16,0,0.9151041666666667,0.46435185185185185,0.008333333333333333,0.013888888888888888
/home/dexter/Desktop/blackbuck/LEK_ANNOTATION/still_images/frame524.jpg,1783,477,1810,493,1796.5,485.0,1080,1920,16,27,0,0.9356770833333333,0.44907407407407407,0.0140625,0.014814814814814815
/home/dexter/Desktop/blackbuck/LEK_ANNOTATION/still_images/frame524.jpg,1888,241,1912,257,1900.0,249.0,1080,1920,16,24,0,0.9895833333333334,0.23055555555555557,0.0125,0.014814814814814815
/home/dexter/Desktop/blackbuck/LEK_ANNOTATION/still_images/frame114.jpg,535,674,550,693,542.5,683.5,1080,1920,19,15,0,0.2825520833333333,0.6328703703703704,0.0078125,0.017592592592592594
/home/dexter/Desktop/blackbuck/LEK_ANNOTATION/still_images/frame114.jpg,570,629,588,647,579.0,638.0,1080,1920,18,18,0,0.3015625,0.5907407407407408,0.009375,0.016666666666666666
/home/dexter/Desktop/blackbuck/LEK_ANNOTATION/still_images/frame114.jpg,603,585,620,609,611.5,597.0,1080,1920,24,17,0,0.3184895833333333,0.5527777777777778,0.008854166666666666,0.022222222222222223
/home/dexter/Desktop/blackbuck/LEK_ANNOTATION/still_images/frame114.jpg,745,554,762,571,753.5,562.5,1080,1920,17,17,0,0.3924479166666667,0.5208333333333334,0.008854166666666666,0.01574074074074074
/home/dexter/Desktop/blackbuck/LEK_ANNOTATION/still_images/frame114.jpg,743,469,768,493,755.5,481.0,1080,1920,24,25,0,0.39348958333333334,0.44537037037037036,0.013020833333333334,0.022222222222222223
/home/dexter/Desktop/blackbuck/LEK_ANNOTATION/still_images/frame114.jpg,777,444,800,457,788.5,450.5,1080,1920,13,23,0,0.41067708333333336,0.41712962962962963,0.011979166666666667,0.012037037037037037
/home/dexter/Desktop/blackbuck/LEK_ANNOTATION/still_images/frame114.jpg,801,406,817,429,809.0,417.5,1080,1920,23,16,0,0.42135416666666664,0.38657407407407407,0.008333333333333333,0.021296296296296296
/home/dexter/Desktop/blackbuck/LEK_ANNOTATION/still_images/frame114.jpg,900,335,922,352,911.0,343.5,1080,1920,17,22,0,0.4744791666666667,0.31805555555555554,0.011458333333333333,0.01574074074074074
/home/dexter/Desktop/blackbuck/LEK_ANNOTATION/still_images/frame114.jpg,969,268,992,285,980.5,276.5,1080,1920,17,23,0,0.5106770833333333,0.25601851851851853,0.011979166666666667,0.01574074074074074
/home/dexter/Desktop/blackbuck/LEK_ANNOTATION/still_images/frame114.jpg,917,740,941,758,929.0,749.0,1080,1920,18,24,0,0.48385416666666664,0.6935185185185185,0.0125,0.016666666666666666
/home/dexter/Desktop/blackbuck/LEK_ANNOTATION/still_images/frame114.jpg,613,1018,625,1040,619.0,1029.0,1080,1920,22,12,0,0.3223958333333333,0.9527777777777777,0.00625,0.020370370370370372
/home/dexter/Desktop/blackbuck/LEK_ANNOTATION/still_images/frame114.jpg,849,967,868,1001,858.5,984.0,1080,1920,34,19,0,0.4471354166666667,0.9111111111111111,0.009895833333333333,0.03148148148148148
/home/dexter/Desktop/blackbuck/LEK_ANNOTATION/still_images/frame114.jpg,1130,1038,1149,1057,1139.5,1047.5,1080,1920,19,19,0,0.5934895833333333,0.9699074074074074,0.009895833333333333,0.017592592592592594
/home/dexter/Desktop/blackbuck/LEK_ANNOTATION/still_images/frame114.jpg,1187,1053,1205,1078,1196.0,1065.5,1080,1920,25,18,0,0.6229166666666667,0.986574074074074,0.009375,0.023148148148148147
/home/dexter/Desktop/blackbuck/LEK_ANNOTATION/still_images/frame114.jpg,1158,1008,1177,1025,1167.5,1016.5,1080,1920,17,19,0,0.6080729166666666,0.9412037037037037,0.009895833333333333,0.01574074074074074
/home/dexter/Desktop/blackbuck/LEK_ANNOTATION/still_images/frame114.jpg,1202,954,1222,979,1212.0,966.5,1080,1920,25,20,0,0.63125,0.8949074074074074,0.010416666666666666,0.023148148148148147
/home/dexter/Desktop/blackbuck/LEK_ANNOTATION/still_images/frame114.jpg,1247,949,1270,967,1258.5,958.0,1080,1920,18,23,0,0.65546875,0.8870370370370371,0.011979166666666667,0.016666666666666666
/home/dexter/Desktop/blackbuck/LEK_ANNOTATION/still_images/frame114.jpg,1242,909,1261,927,1251.5,918.0,1080,1920,18,19,0,0.6518229166666667,0.85,0.009895833333333333,0.016666666666666666
/home/dexter/Desktop/blackbuck/LEK_ANNOTATION/still_images/frame114.jpg,1271,902,1298,918,1284.5,910.0,1080,1920,16,27,0,0.6690104166666667,0.8425925925925926,0.0140625,0.014814814814814815
/home/dexter/Desktop/blackbuck/LEK_ANNOTATION/still_images/frame114.jpg,1279,874,1304,893,1291.5,883.5,1080,1920,19,25,0,0.67265625,0.8180555555555555,0.013020833333333334,0.017592592592592594
/home/dexter/Desktop/blackbuck/LEK_ANNOTATION/still_images/frame114.jpg,1353,773,1375,795,1364.0,784.0,1080,1920,22,22,0,0.7104166666666667,0.725925925925926,0.011458333333333333,0.020370370370370372
/home/dexter/Desktop/blackbuck/LEK_ANNOTATION/still_images/frame114.jpg,1380,753,1400,770,1390.0,761.5,1080,1920,17,20,0,0.7239583333333334,0.7050925925925926,0.010416666666666666,0.01574074074074074
/home/dexter/Desktop/blackbuck/LEK_ANNOTATION/still_images/frame114.jpg,1406,724,1429,746,1417.5,735.0,1080,1920,22,23,0,0.73828125,0.6805555555555556,0.011979166666666667,0.020370370370370372
/home/dexter/Desktop/blackbuck/LEK_ANNOTATION/still_images/frame114.jpg,1456,691,1483,705,1469.5,698.0,1080,1920,14,27,0,0.7653645833333333,0.6462962962962963,0.0140625,0.012962962962962963
/home/dexter/Desktop/blackbuck/LEK_ANNOTATION/still_images/frame114.jpg,1556,601,1584,619,1570.0,610.0,1080,1920,18,28,0,0.8177083333333334,0.5648148148148148,0.014583333333333334,0.016666666666666666
/home/dexter/Desktop/blackbuck/LEK_ANNOTATION/still_images/frame114.jpg,1644,540,1671,556,1657.5,548.0,1080,1920,16,27,0,0.86328125,0.5074074074074074,0.0140625,0.014814814814814815
/home/dexter/Desktop/blackbuck/LEK_ANNOTATION/still_images/frame114.jpg,1722,497,1748,511,1735.0,504.0,1080,1920,14,26,0,0.9036458333333334,0.4666666666666667,0.013541666666666667,0.012962962962962963
/home/dexter/Desktop/blackbuck/LEK_ANNOTATION/still_images/frame114.jpg,1832,386,1859,403,1845.5,394.5,1080,1920,17,27,0,0.9611979166666667,0.36527777777777776,0.0140625,0.01574074074074074
/home/dexter/Desktop/blackbuck/LEK_ANNOTATION/still_images/frame114.jpg,1800,330,1825,347,1812.5,338.5,1080,1920,17,25,0,0.9440104166666666,0.31342592592592594,0.013020833333333334,0.01574074074074074
/home/dexter/Desktop/blackbuck/LEK_ANNOTATION/still_images/frame114.jpg,1836,288,1859,307,1847.5,297.5,1080,1920,19,23,0,0.9622395833333334,0.27546296296296297,0.011979166666666667,0.017592592592592594
/home/dexter/Desktop/blackbuck/LEK_ANNOTATION/still_images/frame114.jpg,1888,252,1911,273,1899.5,262.5,1080,1920,21,23,0,0.9893229166666667,0.24305555555555555,0.011979166666666667,0.019444444444444445
/home/dexter/Desktop/blackbuck/LEK_ANNOTATION/still_images/frame368.jpg,581,618,599,636,590.0,627.0,1080,1920,18,18,0,0.3072916666666667,0.5805555555555556,0.009375,0.016666666666666666
/home/dexter/Desktop/blackbuck/LEK_ANNOTATION/still_images/frame368.jpg,622,574,636,593,629.0,583.5,1080,1920,19,14,0,0.32760416666666664,0.5402777777777777,0.007291666666666667,0.017592592592592594
/home/dexter/Desktop/blackbuck/LEK_ANNOTATION/still_images/frame368.jpg,660,550,689,566,674.5,558.0,1080,1920,16,29,0,0.35130208333333335,0.5166666666666667,0.015104166666666667,0.014814814814814815
/home/dexter/Desktop/blackbuck/LEK_ANNOTATION/still_images/frame368.jpg,790,509,809,531,799.5,520.0,1080,1920,22,19,0,0.41640625,0.48148148148148145,0.009895833333333333,0.020370370370370372
/home/dexter/Desktop/blackbuck/LEK_ANNOTATION/still_images/frame368.jpg,798,407,816,430,807.0,418.5,1080,1920,23,18,0,0.4203125,0.3875,0.009375,0.021296296296296296
/home/dexter/Desktop/blackbuck/LEK_ANNOTATION/still_images/frame368.jpg,848,421,874,433,861.0,427.0,1080,1920,12,26,0,0.4484375,0.39537037037037037,0.013541666666666667,0.011111111111111112
/home/dexter/Desktop/blackbuck/LEK_ANNOTATION/still_images/frame368.jpg,858,360,878,381,868.0,370.5,1080,1920,21,20,0,0.45208333333333334,0.34305555555555556,0.010416666666666666,0.019444444444444445
/home/dexter/Desktop/blackbuck/LEK_ANNOTATION/still_images/frame368.jpg,951,291,978,307,964.5,299.0,1080,1920,16,27,0,0.50234375,0.27685185185185185,0.0140625,0.014814814814814815
/home/dexter/Desktop/blackbuck/LEK_ANNOTATION/still_images/frame368.jpg,1037,255,1059,273,1048.0,264.0,1080,1920,18,22,0,0.5458333333333333,0.24444444444444444,0.011458333333333333,0.016666666666666666
/home/dexter/Desktop/blackbuck/LEK_ANNOTATION/still_images/frame368.jpg,984,712,1008,727,996.0,719.5,1080,1920,15,24,0,0.51875,0.6662037037037037,0.0125,0.013888888888888888
/home/dexter/Desktop/blackbuck/LEK_ANNOTATION/still_images/frame368.jpg,858,968,876,997,867.0,982.5,1080,1920,29,18,0,0.4515625,0.9097222222222222,0.009375,0.026851851851851852
/home/dexter/Desktop/blackbuck/LEK_ANNOTATION/still_images/frame368.jpg,617,1012,635,1033,626.0,1022.5,1080,1920,21,18,0,0.3260416666666667,0.9467592592592593,0.009375,0.019444444444444445
/home/dexter/Desktop/blackbuck/LEK_ANNOTATION/still_images/frame368.jpg,1104,1061,1124,1078,1114.0,1069.5,1080,1920,17,20,0,0.5802083333333333,0.9902777777777778,0.010416666666666666,0.01574074074074074
/home/dexter/Desktop/blackbuck/LEK_ANNOTATION/still_images/frame368.jpg,1134,1037,1150,1065,1142.0,1051.0,1080,1920,28,16,0,0.5947916666666667,0.9731481481481481,0.008333333333333333,0.025925925925925925
/home/dexter/Desktop/blackbuck/LEK_ANNOTATION/still_images/frame368.jpg,1161,1009,1182,1030,1171.5,1019.5,1080,1920,21,21,0,0.61015625,0.9439814814814815,0.0109375,0.019444444444444445
/home/dexter/Desktop/blackbuck/LEK_ANNOTATION/still_images/frame368.jpg,1204,1017,1224,1042,1214.0,1029.5,1080,1920,25,20,0,0.6322916666666667,0.9532407407407407,0.010416666666666666,0.023148148148148147
/home/dexter/Desktop/blackbuck/LEK_ANNOTATION/still_images/frame368.jpg,1179,981,1199,1001,1189.0,991.0,1080,1920,20,20,0,0.6192708333333333,0.9175925925925926,0.010416666666666666,0.018518518518518517
/home/dexter/Desktop/blackbuck/LEK_ANNOTATION/still_images/frame368.jpg,1210,939,1229,966,1219.5,952.5,1080,1920,27,19,0,0.63515625,0.8819444444444444,0.009895833333333333,0.025
/home/dexter/Desktop/blackbuck/LEK_ANNOTATION/still_images/frame368.jpg,1253,895,1275,920,1264.0,907.5,1080,1920,25,22,0,0.6583333333333333,0.8402777777777778,0.011458333333333333,0.023148148148148147
/home/dexter/Desktop/blackbuck/LEK_ANNOTATION/still_images/frame368.jpg,1305,900,1328,924,1316.5,912.0,1080,1920,24,23,0,0.6856770833333333,0.8444444444444444,0.011979166666666667,0.022222222222222223
/home/dexter/Desktop/blackbuck/LEK_ANNOTATION/still_images/frame368.jpg,1288,851,1305,879,1296.5,865.0,1080,1920,28,17,0,0.6752604166666667,0.8009259259259259,0.008854166666666666,0.025925925925925925
/home/dexter/Desktop/blackbuck/LEK_ANNOTATION/still_images/frame368.jpg,1322,854,1343,874,1332.5,864.0,1080,1920,20,21,0,0.6940104166666666,0.8,0.0109375,0.018518518518518517
/home/dexter/Desktop/blackbuck/LEK_ANNOTATION/still_images/frame368.jpg,1313,817,1335,840,1324.0,828.5,1080,1920,23,22,0,0.6895833333333333,0.7671296296296296,0.011458333333333333,0.021296296296296296
/home/dexter/Desktop/blackbuck/LEK_ANNOTATION/still_images/frame368.jpg,1413,721,1439,740,1426.0,730.5,1080,1920,19,26,0,0.7427083333333333,0.6763888888888889,0.013541666666666667,0.017592592592592594
/home/dexter/Desktop/blackbuck/LEK_ANNOTATION/still_images/frame368.jpg,1439,701,1458,715,1448.5,708.0,1080,1920,14,19,0,0.7544270833333333,0.6555555555555556,0.009895833333333333,0.012962962962962963
/home/dexter/Desktop/blackbuck/LEK_ANNOTATION/still_images/frame368.jpg,1467,684,1495,700,1481.0,692.0,1080,1920,16,28,0,0.7713541666666667,0.6407407407407407,0.014583333333333334,0.014814814814814815
/home/dexter/Desktop/blackbuck/LEK_ANNOTATION/still_images/frame368.jpg,1508,632,1532,653,1520.0,642.5,1080,1920,21,24,0,0.7916666666666666,0.5949074074074074,0.0125,0.019444444444444445
/home/dexter/Desktop/blackbuck/LEK_ANNOTATION/still_images/frame368.jpg,1617,558,1642,577,1629.5,567.5,1080,1920,19,25,0,0.8486979166666667,0.5254629629629629,0.013020833333333334,0.017592592592592594
/home/dexter/Desktop/blackbuck/LEK_ANNOTATION/still_images/frame368.jpg,1706,507,1733,525,1719.5,516.0,1080,1920,18,27,0,0.8955729166666667,0.4777777777777778,0.0140625,0.016666666666666666
/home/dexter/Desktop/blackbuck/LEK_ANNOTATION/still_images/frame368.jpg,1853,269,1872,298,1862.5,283.5,1080,1920,29,19,0,0.9700520833333334,0.2625,0.009895833333333333,0.026851851851851852
/home/dexter/Desktop/blackbuck/LEK_ANNOTATION/still_images/frame368.jpg,1889,239,1918,260,1903.5,249.5,1080,1920,21,29,0,0.99140625,0.2310185185185185,0.015104166666666667,0.019444444444444445
/home/dexter/Desktop/blackbuck/LEK_ANNOTATION/still_images/frame416.jpg,625,1002,647,1021,636.0,1011.5,1080,1920,19,22,0,0.33125,0.9365740740740741,0.011458333333333333,0.017592592592592594
/home/dexter/Desktop/blackbuck/LEK_ANNOTATION/still_images/frame416.jpg,589,604,606,622,597.5,613.0,1080,1920,18,17,0,0.3111979166666667,0.5675925925925925,0.008854166666666666,0.016666666666666666
/home/dexter/Desktop/blackbuck/LEK_ANNOTATION/still_images/frame416.jpg,629,563,649,576,639.0,569.5,1080,1920,13,20,0,0.3328125,0.5273148148148148,0.010416666666666666,0.012037037037037037
/home/dexter/Desktop/blackbuck/LEK_ANNOTATION/still_images/frame416.jpg,677,548,702,562,689.5,555.0,1080,1920,14,25,0,0.35911458333333335,0.5138888888888888,0.013020833333333334,0.012962962962962963
/home/dexter/Desktop/blackbuck/LEK_ANNOTATION/still_images/frame416.jpg,795,502,816,523,805.5,512.5,1080,1920,21,21,0,0.41953125,0.47453703703703703,0.0109375,0.019444444444444445
/home/dexter/Desktop/blackbuck/LEK_ANNOTATION/still_images/frame416.jpg,806,396,826,420,816.0,408.0,1080,1920,24,20,0,0.425,0.37777777777777777,0.010416666666666666,0.022222222222222223
/home/dexter/Desktop/blackbuck/LEK_ANNOTATION/still_images/frame416.jpg,861,408,883,429,872.0,418.5,1080,1920,21,22,0,0.45416666666666666,0.3875,0.011458333333333333,0.019444444444444445
/home/dexter/Desktop/blackbuck/LEK_ANNOTATION/still_images/frame416.jpg,865,346,888,371,876.5,358.5,1080,1920,25,23,0,0.45651041666666664,0.33194444444444443,0.011979166666666667,0.023148148148148147
/home/dexter/Desktop/blackbuck/LEK_ANNOTATION/still_images/frame416.jpg,967,285,992,300,979.5,292.5,1080,1920,15,25,0,0.51015625,0.2708333333333333,0.013020833333333334,0.013888888888888888
/home/dexter/Desktop/blackbuck/LEK_ANNOTATION/still_images/frame416.jpg,1049,250,1075,267,1062.0,258.5,1080,1920,17,26,0,0.553125,0.23935185185185184,0.013541666666666667,0.01574074074074074
/home/dexter/Desktop/blackbuck/LEK_ANNOTATION/still_images/frame416.jpg,859,965,876,993,867.5,979.0,1080,1920,28,17,0,0.4518229166666667,0.9064814814814814,0.008854166666666666,0.025925925925925925
/home/dexter/Desktop/blackbuck/LEK_ANNOTATION/still_images/frame416.jpg,996,700,1021,721,1008.5,710.5,1080,1920,21,25,0,0.5252604166666667,0.6578703703703703,0.013020833333333334,0.019444444444444445
/home/dexter/Desktop/blackbuck/LEK_ANNOTATION/still_images/frame416.jpg,1110,1049,1136,1074,1123.0,1061.5,1080,1920,25,26,0,0.5848958333333333,0.9828703703703704,0.013541666666666667,0.023148148148148147
/home/dexter/Desktop/blackbuck/LEK_ANNOTATION/still_images/frame416.jpg,1143,1027,1162,1050,1152.5,1038.5,1080,1920,23,19,0,0.6002604166666666,0.961574074074074,0.009895833333333333,0.021296296296296296
/home/dexter/Desktop/blackbuck/LEK_ANNOTATION/still_images/frame416.jpg,1174,992,1193,1020,1183.5,1006.0,1080,1920,28,19,0,0.61640625,0.9314814814814815,0.009895833333333333,0.025925925925925925
/home/dexter/Desktop/blackbuck/LEK_ANNOTATION/still_images/frame416.jpg,1210,1008,1228,1030,1219.0,1019.0,1080,1920,22,18,0,0.6348958333333333,0.9435185185185185,0.009375,0.020370370370370372
/home/dexter/Desktop/blackbuck/LEK_ANNOTATION/still_images/frame416.jpg,1190,971,1210,991,1200.0,981.0,1080,1920,20,20,0,0.625,0.9083333333333333,0.010416666666666666,0.018518518518518517
/home/dexter/Desktop/blackbuck/LEK_ANNOTATION/still_images/frame416.jpg,1218,933,1238,951,1228.0,942.0,1080,1920,18,20,0,0.6395833333333333,0.8722222222222222,0.010416666666666666,0.016666666666666666
/home/dexter/Desktop/blackbuck/LEK_ANNOTATION/still_images/frame416.jpg,1263,889,1286,907,1274.5,898.0,1080,1920,18,23,0,0.6638020833333333,0.8314814814814815,0.011979166666666667,0.016666666666666666
/home/dexter/Desktop/blackbuck/LEK_ANNOTATION/still_images/frame416.jpg,1317,893,1341,913,1329.0,903.0,1080,1920,20,24,0,0.6921875,0.8361111111111111,0.0125,0.018518518518518517
/home/dexter/Desktop/blackbuck/LEK_ANNOTATION/still_images/frame416.jpg,1297,841,1315,867,1306.0,854.0,1080,1920,26,18,0,0.6802083333333333,0.7907407407407407,0.009375,0.024074074074074074
/home/dexter/Desktop/blackbuck/LEK_ANNOTATION/still_images/frame416.jpg,1331,849,1357,866,1344.0,857.5,1080,1920,17,26,0,0.7,0.7939814814814815,0.013541666666666667,0.01574074074074074
/home/dexter/Desktop/blackbuck/LEK_ANNOTATION/still_images/frame416.jpg,1320,807,1347,831,1333.5,819.0,1080,1920,24,27,0,0.69453125,0.7583333333333333,0.0140625,0.022222222222222223
/home/dexter/Desktop/blackbuck/LEK_ANNOTATION/still_images/frame416.jpg,1420,711,1449,730,1434.5,720.5,1080,1920,19,29,0,0.7471354166666667,0.6671296296296296,0.015104166666666667,0.017592592592592594
/home/dexter/Desktop/blackbuck/LEK_ANNOTATION/still_images/frame416.jpg,1452,691,1474,706,1463.0,698.5,1080,1920,15,22,0,0.7619791666666667,0.6467592592592593,0.011458333333333333,0.013888888888888888
/home/dexter/Desktop/blackbuck/LEK_ANNOTATION/still_images/frame416.jpg,1475,668,1504,691,1489.5,679.5,1080,1920,23,29,0,0.77578125,0.6291666666666667,0.015104166666666667,0.021296296296296296
/home/dexter/Desktop/blackbuck/LEK_ANNOTATION/still_images/frame416.jpg,1519,617,1542,640,1530.5,628.5,1080,1920,23,23,0,0.7971354166666667,0.5819444444444445,0.011979166666666667,0.021296296296296296
/home/dexter/Desktop/blackbuck/LEK_ANNOTATION/still_images/frame416.jpg,1628,553,1653,566,1640.5,559.5,1080,1920,13,25,0,0.8544270833333333,0.5180555555555556,0.013020833333333334,0.012037037037037037
/home/dexter/Desktop/blackbuck/LEK_ANNOTATION/still_images/frame416.jpg,1717,503,1748,517,1732.5,510.0,1080,1920,14,31,0,0.90234375,0.4722222222222222,0.016145833333333335,0.012962962962962963
/home/dexter/Desktop/blackbuck/LEK_ANNOTATION/still_images/frame416.jpg,1748,488,1774,503,1761.0,495.5,1080,1920,15,26,0,0.9171875,0.4587962962962963,0.013541666666666667,0.013888888888888888
/home/dexter/Desktop/blackbuck/LEK_ANNOTATION/still_images/frame416.jpg,1862,262,1884,282,1873.0,272.0,1080,1920,20,22,0,0.9755208333333333,0.2518518518518518,0.011458333333333333,0.018518518518518517
/home/dexter/Desktop/blackbuck/LEK_ANNOTATION/still_images/frame462.jpg,560,641,576,657,568.0,649.0,1080,1920,16,16,0,0.29583333333333334,0.600925925925926,0.008333333333333333,0.014814814814814815
/home/dexter/Desktop/blackbuck/LEK_ANNOTATION/still_images/frame462.jpg,598,597,617,611,607.5,604.0,1080,1920,14,19,0,0.31640625,0.5592592592592592,0.009895833333333333,0.012962962962962963
/home/dexter/Desktop/blackbuck/LEK_ANNOTATION/still_images/frame462.jpg,641,554,660,570,650.5,562.0,1080,1920,16,19,0,0.33880208333333334,0.5203703703703704,0.009895833333333333,0.014814814814814815
/home/dexter/Desktop/blackbuck/LEK_ANNOTATION/still_images/frame462.jpg,685,547,712,558,698.5,552.5,1080,1920,11,27,0,0.36380208333333336,0.5115740740740741,0.0140625,0.010185185185185186
/home/dexter/Desktop/blackbuck/LEK_ANNOTATION/still_images/frame462.jpg,808,493,830,511,819.0,502.0,1080,1920,18,22,0,0.4265625,0.4648148148148148,0.011458333333333333,0.016666666666666666
/home/dexter/Desktop/blackbuck/LEK_ANNOTATION/still_images/frame462.jpg,819,387,841,405,830.0,396.0,1080,1920,18,22,0,0.4322916666666667,0.36666666666666664,0.011458333333333333,0.016666666666666666
/home/dexter/Desktop/blackbuck/LEK_ANNOTATION/still_images/frame462.jpg,875,408,896,423,885.5,415.5,1080,1920,15,21,0,0.46119791666666665,0.38472222222222224,0.0109375,0.013888888888888888
/home/dexter/Desktop/blackbuck/LEK_ANNOTATION/still_images/frame462.jpg,878,339,899,361,888.5,350.0,1080,1920,22,21,0,0.4627604166666667,0.32407407407407407,0.0109375,0.020370370370370372
/home/dexter/Desktop/blackbuck/LEK_ANNOTATION/still_images/frame462.jpg,982,279,1004,294,993.0,286.5,1080,1920,15,22,0,0.5171875,0.2652777777777778,0.011458333333333333,0.013888888888888888
/home/dexter/Desktop/blackbuck/LEK_ANNOTATION/still_images/frame462.jpg,1062,252,1089,262,1075.5,257.0,1080,1920,10,27,0,0.56015625,0.23796296296296296,0.0140625,0.009259259259259259
/home/dexter/Desktop/blackbuck/LEK_ANNOTATION/still_images/frame462.jpg,637,999,660,1015,648.5,1007.0,1080,1920,16,23,0,0.3377604166666667,0.9324074074074075,0.011979166666666667,0.014814814814814815
/home/dexter/Desktop/blackbuck/LEK_ANNOTATION/still_images/frame462.jpg,860,964,878,992,869.0,978.0,1080,1920,28,18,0,0.45260416666666664,0.9055555555555556,0.009375,0.025925925925925925
/home/dexter/Desktop/blackbuck/LEK_ANNOTATION/still_images/frame462.jpg,1006,695,1029,712,1017.5,703.5,1080,1920,17,23,0,0.5299479166666666,0.6513888888888889,0.011979166666666667,0.01574074074074074
/home/dexter/Desktop/blackbuck/LEK_ANNOTATION/still_images/frame462.jpg,1124,1047,1147,1067,1135.5,1057.0,1080,1920,20,23,0,0.59140625,0.9787037037037037,0.011979166666666667,0.018518518518518517
/home/dexter/Desktop/blackbuck/LEK_ANNOTATION/still_images/frame462.jpg,1148,1020,1171,1039,1159.5,1029.5,1080,1920,19,23,0,0.60390625,0.9532407407407407,0.011979166666666667,0.017592592592592594
/home/dexter/Desktop/blackbuck/LEK_ANNOTATION/still_images/frame462.jpg,1220,1002,1238,1022,1229.0,1012.0,1080,1920,20,18,0,0.6401041666666667,0.937037037037037,0.009375,0.018518518518518517
/home/dexter/Desktop/blackbuck/LEK_ANNOTATION/still_images/frame462.jpg,1183,985,1204,1004,1193.5,994.5,1080,1920,19,21,0,0.6216145833333333,0.9208333333333333,0.0109375,0.017592592592592594
/home/dexter/Desktop/blackbuck/LEK_ANNOTATION/still_images/frame462.jpg,1202,963,1219,982,1210.5,972.5,1080,1920,19,17,0,0.63046875,0.9004629629629629,0.008854166666666666,0.017592592592592594
/home/dexter/Desktop/blackbuck/LEK_ANNOTATION/still_images/frame462.jpg,1231,924,1255,942,1243.0,933.0,1080,1920,18,24,0,0.6473958333333333,0.8638888888888889,0.0125,0.016666666666666666
/home/dexter/Desktop/blackbuck/LEK_ANNOTATION/still_images/frame462.jpg,1327,881,1352,904,1339.5,892.5,1080,1920,23,25,0,0.69765625,0.8263888888888888,0.013020833333333334,0.021296296296296296
/home/dexter/Desktop/blackbuck/LEK_ANNOTATION/still_images/frame462.jpg,1304,830,1322,856,1313.0,843.0,1080,1920,26,18,0,0.6838541666666667,0.7805555555555556,0.009375,0.024074074074074074
/home/dexter/Desktop/blackbuck/LEK_ANNOTATION/still_images/frame462.jpg,1341,839,1365,863,1353.0,851.0,1080,1920,24,24,0,0.7046875,0.787962962962963,0.0125,0.022222222222222223
/home/dexter/Desktop/blackbuck/LEK_ANNOTATION/still_images/frame462.jpg,1334,800,1354,820,1344.0,810.0,1080,1920,20,20,0,0.7,0.75,0.010416666666666666,0.018518518518518517
/home/dexter/Desktop/blackbuck/LEK_ANNOTATION/still_images/frame462.jpg,1437,702,1464,719,1450.5,710.5,1080,1920,17,27,0,0.75546875,0.6578703703703703,0.0140625,0.01574074074074074
/home/dexter/Desktop/blackbuck/LEK_ANNOTATION/still_images/frame462.jpg,1468,682,1488,700,1478.0,691.0,1080,1920,18,20,0,0.7697916666666667,0.6398148148148148,0.010416666666666666,0.016666666666666666
/home/dexter/Desktop/blackbuck/LEK_ANNOTATION/still_images/frame462.jpg,1491,657,1515,684,1503.0,670.5,1080,1920,27,24,0,0.7828125,0.6208333333333333,0.0125,0.025
/home/dexter/Desktop/blackbuck/LEK_ANNOTATION/still_images/frame462.jpg,1526,613,1556,631,1541.0,622.0,1080,1920,18,30,0,0.8026041666666667,0.575925925925926,0.015625,0.016666666666666666
/home/dexter/Desktop/blackbuck/LEK_ANNOTATION/still_images/frame462.jpg,1643,543,1663,559,1653.0,551.0,1080,1920,16,20,0,0.8609375,0.5101851851851852,0.010416666666666666,0.014814814814814815
/home/dexter/Desktop/blackbuck/LEK_ANNOTATION/still_images/frame462.jpg,1731,498,1758,511,1744.5,504.5,1080,1920,13,27,0,0.90859375,0.4671296296296296,0.0140625,0.012037037037037037
/home/dexter/Desktop/blackbuck/LEK_ANNOTATION/still_images/frame462.jpg,1762,483,1791,500,1776.5,491.5,1080,1920,17,29,0,0.9252604166666667,0.4550925925925926,0.015104166666666667,0.01574074074074074
/home/dexter/Desktop/blackbuck/LEK_ANNOTATION/still_images/frame462.jpg,1872,251,1894,270,1883.0,260.5,1080,1920,19,22,0,0.9807291666666667,0.2412037037037037,0.011458333333333333,0.017592592592592594
/home/dexter/Desktop/blackbuck/LEK_ANNOTATION/still_images/frame154.jpg,540,660,555,682,547.5,671.0,1080,1920,22,15,0,0.28515625,0.6212962962962963,0.0078125,0.020370370370370372
/home/dexter/Desktop/blackbuck/LEK_ANNOTATION/still_images/frame154.jpg,578,618,598,640,588.0,629.0,1080,1920,22,20,0,0.30625,0.5824074074074074,0.010416666666666666,0.020370370370370372
/home/dexter/Desktop/blackbuck/LEK_ANNOTATION/still_images/frame154.jpg,612,575,629,599,620.5,587.0,1080,1920,24,17,0,0.32317708333333334,0.5435185185185185,0.008854166666666666,0.022222222222222223
/home/dexter/Desktop/blackbuck/LEK_ANNOTATION/still_images/frame154.jpg,752,545,773,563,762.5,554.0,1080,1920,18,21,0,0.3971354166666667,0.512962962962963,0.0109375,0.016666666666666666
/home/dexter/Desktop/blackbuck/LEK_ANNOTATION/still_images/frame154.jpg,750,459,773,484,761.5,471.5,1080,1920,25,23,0,0.3966145833333333,0.43657407407407406,0.011979166666666667,0.023148148148148147
/home/dexter/Desktop/blackbuck/LEK_ANNOTATION/still_images/frame154.jpg,790,439,817,455,803.5,447.0,1080,1920,16,27,0,0.41848958333333336,0.41388888888888886,0.0140625,0.014814814814814815
/home/dexter/Desktop/blackbuck/LEK_ANNOTATION/still_images/frame154.jpg,810,397,827,420,818.5,408.5,1080,1920,23,17,0,0.42630208333333336,0.37824074074074077,0.008854166666666666,0.021296296296296296
/home/dexter/Desktop/blackbuck/LEK_ANNOTATION/still_images/frame154.jpg,910,322,931,345,920.5,333.5,1080,1920,23,21,0,0.47942708333333334,0.3087962962962963,0.0109375,0.021296296296296296
/home/dexter/Desktop/blackbuck/LEK_ANNOTATION/still_images/frame154.jpg,981,266,1004,285,992.5,275.5,1080,1920,19,23,0,0.5169270833333334,0.2550925925925926,0.011979166666666667,0.017592592592592594
/home/dexter/Desktop/blackbuck/LEK_ANNOTATION/still_images/frame154.jpg,614,1019,627,1038,620.5,1028.5,1080,1920,19,13,0,0.32317708333333334,0.9523148148148148,0.0067708333333333336,0.017592592592592594
/home/dexter/Desktop/blackbuck/LEK_ANNOTATION/still_images/frame154.jpg,850,972,866,997,858.0,984.5,1080,1920,25,16,0,0.446875,0.9115740740740741,0.008333333333333333,0.023148148148148147
/home/dexter/Desktop/blackbuck/LEK_ANNOTATION/still_images/frame154.jpg,930,735,952,754,941.0,744.5,1080,1920,19,22,0,0.4901041666666667,0.6893518518518519,0.011458333333333333,0.017592592592592594
/home/dexter/Desktop/blackbuck/LEK_ANNOTATION/still_images/frame154.jpg,1141,1031,1157,1051,1149.0,1041.0,1080,1920,20,16,0,0.5984375,0.9638888888888889,0.008333333333333333,0.018518518518518517
/home/dexter/Desktop/blackbuck/LEK_ANNOTATION/still_images/frame154.jpg,1172,996,1188,1018,1180.0,1007.0,1080,1920,22,16,0,0.6145833333333334,0.9324074074074075,0.008333333333333333,0.020370370370370372
/home/dexter/Desktop/blackbuck/LEK_ANNOTATION/still_images/frame154.jpg,1194,1044,1212,1065,1203.0,1054.5,1080,1920,21,18,0,0.6265625,0.9763888888888889,0.009375,0.019444444444444445
/home/dexter/Desktop/blackbuck/LEK_ANNOTATION/still_images/frame154.jpg,1209,944,1229,971,1219.0,957.5,1080,1920,27,20,0,0.6348958333333333,0.8865740740740741,0.010416666666666666,0.025
/home/dexter/Desktop/blackbuck/LEK_ANNOTATION/still_images/frame154.jpg,1258,937,1276,959,1267.0,948.0,1080,1920,22,18,0,0.6598958333333333,0.8777777777777778,0.009375,0.020370370370370372
/home/dexter/Desktop/blackbuck/LEK_ANNOTATION/still_images/frame154.jpg,1246,900,1268,920,1257.0,910.0,1080,1920,20,22,0,0.6546875,0.8425925925925926,0.011458333333333333,0.018518518518518517
/home/dexter/Desktop/blackbuck/LEK_ANNOTATION/still_images/frame154.jpg,1280,896,1304,913,1292.0,904.5,1080,1920,17,24,0,0.6729166666666667,0.8375,0.0125,0.01574074074074074
/home/dexter/Desktop/blackbuck/LEK_ANNOTATION/still_images/frame154.jpg,1283,859,1304,891,1293.5,875.0,1080,1920,32,21,0,0.6736979166666667,0.8101851851851852,0.0109375,0.02962962962962963
/home/dexter/Desktop/blackbuck/LEK_ANNOTATION/still_images/frame154.jpg,1366,763,1385,783,1375.5,773.0,1080,1920,20,19,0,0.71640625,0.7157407407407408,0.009895833333333333,0.018518518518518517
/home/dexter/Desktop/blackbuck/LEK_ANNOTATION/still_images/frame154.jpg,1389,745,1407,763,1398.0,754.0,1080,1920,18,18,0,0.728125,0.6981481481481482,0.009375,0.016666666666666666
/home/dexter/Desktop/blackbuck/LEK_ANNOTATION/still_images/frame154.jpg,1416,719,1440,742,1428.0,730.5,1080,1920,23,24,0,0.74375,0.6763888888888889,0.0125,0.021296296296296296
/home/dexter/Desktop/blackbuck/LEK_ANNOTATION/still_images/frame154.jpg,1467,678,1494,701,1480.5,689.5,1080,1920,23,27,0,0.77109375,0.638425925925926,0.0140625,0.021296296296296296
/home/dexter/Desktop/blackbuck/LEK_ANNOTATION/still_images/frame154.jpg,1567,597,1593,612,1580.0,604.5,1080,1920,15,26,0,0.8229166666666666,0.5597222222222222,0.013541666666666667,0.013888888888888888
/home/dexter/Desktop/blackbuck/LEK_ANNOTATION/still_images/frame154.jpg,1654,533,1681,548,1667.5,540.5,1080,1920,15,27,0,0.8684895833333334,0.500462962962963,0.0140625,0.013888888888888888
/home/dexter/Desktop/blackbuck/LEK_ANNOTATION/still_images/frame154.jpg,1733,496,1754,510,1743.5,503.0,1080,1920,14,21,0,0.9080729166666667,0.46574074074074073,0.0109375,0.012962962962962963
/home/dexter/Desktop/blackbuck/LEK_ANNOTATION/still_images/frame154.jpg,1842,379,1867,398,1854.5,388.5,1080,1920,19,25,0,0.9658854166666667,0.3597222222222222,0.013020833333333334,0.017592592592592594
/home/dexter/Desktop/blackbuck/LEK_ANNOTATION/still_images/frame154.jpg,1809,321,1834,338,1821.5,329.5,1080,1920,17,25,0,0.9486979166666667,0.3050925925925926,0.013020833333333334,0.01574074074074074
/home/dexter/Desktop/blackbuck/LEK_ANNOTATION/still_images/frame154.jpg,1846,280,1866,297,1856.0,288.5,1080,1920,17,20,0,0.9666666666666667,0.2671296296296296,0.010416666666666666,0.01574074074074074
/home/dexter/Desktop/blackbuck/LEK_ANNOTATION/still_images/frame154.jpg,1892,246,1918,262,1905.0,254.0,1080,1920,16,26,0,0.9921875,0.2351851851851852,0.013541666666666667,0.014814814814814815
